А Вадим Черняк?	Tu
А Вам известно нечто большее, чем, например, мне?	Td
А Вы все пытаетесь умничать, злорадствовать?	Tu
А СМС не проще оповещать?	Tu
А бренд в культуре?	Tu
А был ли Пётр I в Орле?	Td
А был ли мальчик, а была ли девочка?	Tu
А была ли альтернатива?	Td
А в России Майдан возможен?	Tu
А в России у вас есть враги?	Td
А в глубинке, кому нужно ставить глонасс?	Tu
А в каких отраслях, на ваш взгляд, необходимо развивать инжиниринг?	Tu
А в плен захватывали?	Tu
А в чём подвох?	Tu
А вас уже ограбили?	Tu
А вас цифры ничуть не удивляют?	Tu
А вдруг нет?	Tu
А вдруг окажется, что талант у него есть, но рядовой?	Tu
А вдруг они попадут в руки злоумышленников?	Td
А вдруг та, которую купил, жене не понравится?	Tu
А во мне, наверное, больше цинизма, что ли?	Tu
А вообще, а где классификация источников?	Td
А вопрос поставлен, согласитесь?	Tu
А вот есть генетика, и Сергей Киселёв в науке кто?	Tu
А всё отчего?	Tu
А вы в районе живёте?	Td
А вы всех гостей зарегистрировали?	Tu
А вы же патриот?	Tu
А вы как думали, ребята?	Td
А вы лично с ним встречались, общались?	Tu
А вы могли бы сейчас сформулировать, какие области вас интересуют?	Tu
А вы чем занимаетесь?	Td
А вы?	Tu
А выключение двух миллиардов?	Tu
А где Вы видели нормальных?	Td
А где доказательства?	Tu
А где же демократия?	Td
А где же принц?	Tu
А где же романтика?	Td
А где же свет в конце тоннеля?	Tu
А где же шарик?	Td
А где кирпич?	Tu
А где купаться?	Tu
А где лечат больных лихорадкой?	Td
А где мы находимся?	Td
А где он, международный терроризм?	Tu
А где сегодня наша интеллигенция?	Tu
А где тренироваться?	Tu
А где, как не у военных, лучше всего следят за порядком и временем?	Td
А дальше что было?	Td
А дедок что требует?	Td
А действительно, на кой чёрт нужны электрички?	Td
А делить кормушку они не собирались, зачем?	Tu
А десерт?	Tu
А другие застройщики?	Tu
А друзья в бизнесе есть?	Tu
А если бы был аукцион?	Tu
А если дело происходит в джунглях, в горах?	Tu
А если ещё, к примеру, и на тракторе, которому глубоко за двадцать?	Tu
А если жилплощадь съёмная?	Tu
А если командировка?	Tu
А если менеджер?	Tu
А если не согласятся, то что?	Td
А если осечка или, что ещё хуже, разрыв ствола?	Tu
А если судороги у ребёнка?	Tu
А если у меня наследственность?	Tu
А если уже съездил, а денег теперь нет, и не светит в ближайший месяц?	Tu
А есть ли смысл?	Td
А зачем всё включать?	Tu
А зачем её вводить?	Td
А зачем им жалеть русских?	Tu
А зачем нужны университеты?	Tu
А зачем убеждать людей, занимающихся наукой, защищать диссертацию?	Tu
А зачем уезжать?	Tu
А зачем это для водохранилища?	Td
А зачем, какая будет отдача?	Tu
А здравоохранение?	Tu
А известность?	Tu
А именно, в чём разница, почему это принципиально?	Td
А как быть больным и пожилым людям, инвалидам, пенсионерам?	Tu
А как быть, например, с теми, кто живёт в гражданском браке?	Tu
А как вам этот шедевр?	Tu
А как должны выглядеть реформы?	Td
А как же Александр Сергеевич?	Tu
А как же быть с долгами?	Td
А как же враги?	Tu
А как же всё начиналось?	Td
А как же иначе могу я об этом узнать?	Td
А как же модные журналы, с которых всё, собственно, и началось?	Tu
А как же моя аллергия?	Td
А как же по-другому?	Td
А как же растениеводство?	Tu
А как же слухи?	Td
А как мне в это верить?	Td
А как насчёт летних площадок?	Td
А как насчёт?	Tu
А как переправлять?	Tu
А каким будет объем грузоперевозок?	Tu
А каким стал, по-вашему, год для Академии наук?	Tu
А какое это имеет значение?	Td
А какой один из самых любимых фильмов у всех россиян?	Tu
А какой он у нас, фундамент?	Tu
А какой, кстати, конкурс в этом году был в Финансовой университет?	Td
А когда подсекать?	Tu
А кто будет пенсионный фонд формировать?	Tu
А кто в восторге-то?	Td
А кто же в деньгах не нуждается?	Td
А кто и зачем их спровоцировал?	Td
А кто обещал, что будет легко?	Td
А кто тебя заставляет?	Tu
А кто, как не классный руководитель, нам ближе всех из них?	Td
А куда идти, если у вас есть миллиард?	Tu
А куда мы идём, товарищи?	Tu
А куда уж скромнее?	Td
А курящих мам на детских площадках?	Tu
А лежачий ли камень?	Td
А мне прививку?	Tu
А мне что взамен?	Tu
А может ПДД будем соблюдать?	Tu
А может быть, дело не в форме мормышки?	Tu
А может, и миллиардами?	Tu
А может, кирпичи не те?	Tu
А может, начать закаляться?	Tu
А может, поговорим?	Tu
А может, ребёнок краденый?	Tu
А может, с рыбой?	Tu
А может, сойдёт и смартфон?	Tu
А может, ты не гражданин России?	Tu
А мы чё, знакомы?	Tu
А на других системах?	Tu
А на нацизм, значит, разрешается скатываться, только близким вам по духу?	Tu
А нам-то это жизнь облегчит?	Tu
А не пошли бы вы, товарищи, в музей?	Tu
А некоторые даже на службу в армию, Родину защищают, слышали о таких?	Td
А необычные украшения, аксессуары?	Td
А неудачные?	Tu
А ну как все мужики, забыв приличия, такому примеру последуют?	Td
А нынешнее?	Tu
А нынче ситуация улучшилась?	Tu
А о чём мечтает?	Tu
А огорчения?	Tu
А он?	Tu
А оперативники?	Tu
А парни молодые, а мужчины в возрасте?	Tu
А пенсии и пособия?	Tu
А пересортица?	Tu
А по поводу помощи, Дмитрий, я же тролль, какой с меня спрос и польза от меня?	Tu
А по-человечески?	Tu
А потом что?	Td
А почему бы нет?	Tu
А почему вы решили, что оно игнорирует?	Tu
А почему конвой?	Td
А почему не в лицей, лицей хуже, да?	Tu
А почему не все шесть фабрик в Украине?	Td
А почему она чувствовала, что вам будет интересна именно химия, а не математика, не физика?	Td
А почему, собственно, мы вот так с этим согласились сразу?	Tu
А представляете, закроют через десять?	Td
А про концепцию?	Tu
А профессию?	Tu
А разве найдётся лучший пехотинец, чем бывший русский крестьянин, колхозник?	Tu
А ружьё видела?	Tu
А с Донецком, кто спровоцировал?	Td
А с детьми погулять?	Tu
А с онкологией?	Tu
А с чего ты взяла, что это он?	Td
А сегодня можно уже обращаться к нотариусу, чтобы помог рассчитаться?	Td
А сколько электричество?	Td
А сколько этих дум в городе создаётся?	Td
А следователей, секретарей?	Td
А слышал, на том озере карась до сих пор ловится?	Td
А такая цель и рамка, как независимость, в 90-х годах обсуждалась в России?	Td
А те же помидоры?	Td
А тебе до звезды?	Tu
А теперь в снежки задумал?	Td
А теперь руки крутить начали?	Td
А теперь хочу услышать, как вы ответили за то, что получили?	Td
А то ведь, помните?	Tu
А то, что у вас связи во власти и среди силовиков?	Td
А ты боишься высоты?	Td
А ты веришь?	Tu
А ты опять в поиске?	Tu
А ты помнишь?	Tu
А ты умеешь держать язык за зубами?	Td
А ты хоть когда-нибудь был в регионах?	Tu
А у РВ уже есть ваш телефон, чтобы связаться с вами и приехать?	Td
А у вас будет своё радио и телевидение?	Td
А у вас возможен союз либералов, коммунистов и националистов?	Tu
А у вас есть электромобиль?	Tu
А у всех ли людей бывает осенняя хандра?	Td
А узбеки будут?	Tu
А фен нужен или не очень-то?	Tu
А хочешь, новеньких приведём?	Td
А чего ты ожидал?	Td
А чего тянуть?	Td
А чей тогда?	Td
А человечески?	Tu
А чем они хуже вас, драгоценных?	Tu
А чем ты открыл это?	Td
А чему удивляться?	Td
А черешня?	Tu
А что в сундуке?	Tu
А что во-первых?	Tu
А что вы делали в Минске в 1970-х?	Tu
А что вы здесь делаете?	Tu
А что делать дальше?	Td
А что делать малоимущим?	Td
А что делать с армией, педагогами, учителями, врачами?	Tu
А что же Дагестан, Ингушетия и Чечня, к которым так стремятся разжечь нашу ненависть враги России?	Td
А что же глянец?	Tu
А что же говорят о местных продуктах, те, кто их реализуют?	Td
А что же думают другие студенты-первокурсники?	Td
А что же эксперимент?	Tu
А что и кому бережёт радиоточка?	Td
А что мне за это будет?	Td
А что мне с этим делать?	Td
А что молодёжь хочет, к чему стремится?	Tu
А что такое Интернет-пресса?	Td
А что такое архимандрит-губернатор?	Tu
А что такое генплан?	Td
А что там, наверху?	Tu
А что это за происшествие?	Td
А что, вина остальных, которым выбирают меру пресечения, доказана?	Tu
А что, есть ему альтернатива?	Tu
А что, на отца с матерью вешать?	Td
А что, руководство округа, правда, интересные идеи?	Tu
А что, у нас возят питьевую воду, когда отключают?	Tu
А что?	Tu
А чья может быть степень?	Td
А электрический кабель участвует?	Tu
А электрички?	Tu
А электроснабжение?	Tu
А эти апелляции помогали?	Tu
А, в принципе, технологические окна это надолго?	Tu
А, полиция, где и умерла старушка не причём?	Tu
А?	Tu
АС, уважаемая, а чего, Вы против экономии?	Tu
Ага, прощения запросил?	Td
Адрес будете записывать?	Td
Актёры удивлялись, мол, как ты так мог взять зрительный зал?	Td
Алёна, а есть подробности?	Td
Амиго, то есть всё же снял Егоров?	Tu
Андрей Бочаров будущий губернатор?	Tu
Андрея Турчака в Петербург?	Tu
Арбитражный суд или общей юрисдикции?	Tu
Аудиенция у Козлова?	Tu
Ах, нет?	Tu
Банк закрывается?	Tu
Батареи есть внутри?	Td
Батька, разве я не стараюсь?	Tu
Бежать в аптеку?	Tu
Без ЧП?	Tu
Без баков с топливом?	Tu
Без дураков?	Tu
Без мотыля?	Tu
Без паники?	Tu
Без чего невозможен современный университет?	Td
Безнадёжная территория?	Tu
Безобразие, правда?	Tu
Белый террор?	Tu
Беседка из арматуры?	Tu
Билет будет дешевле, если сразу купить в обе стороны?	Td
Богиня чего?	Tu
Боитесь разочарований?	Tu
Боишься дефицита?	Tu
Большой инструмент?	Tu
Борис Немцов?	Tu
Бороться с работодателем?	Tu
Борьба с ИГИЛ важна, но, разве, у нас нет более насущных дел в своей стране?	Tu
Боязнь паники или попытка скрыть собственное разгильдяйство?	Td
Брать средние цены по региону, по городу, по стране?	Tu
Бронирование номера есть с авансом?	Tu
Будем возвращаться тем же путём?	Tu
Будем пополнять собой ряды бомжей?	Tu
Будет ли заметен эффект?	Td
Будет ли кому возвращаться?	Td
Будет ли фильтр?	Td
Будет этого достаточно?	Td
Будете его популяризировать?	Tu
Будете записываться?	Td
Будете пытаться реабилитироваться?	Tu
Буду ли сниматься в кино ещё?	Tu
Будут во время похода крутые подъёмы?	Tu
Будут ли их компенсировать, как нынешние вклады физических лиц?	Tu
Будут ли рады израильтяне?	Td
Будут ли учтены эти предложения?	Tu
Будут новые атаки?	Td
Бузить начали черногорцы?	Td
Букет, значит?	Tu
Буше испорченный художник?	Tu
Бывают здесь лавины?	Td
Был ли Хрущёв великим руководителем?	Tu
Был ли инсульт у ваших близких родственников?	Tu
Были ли среди любимых книг детства научно-популярные?	Tu
Было бы возможно?	Tu
Было ли это для вас неожиданностью?	Td
Быть может, играть с ним, как с маленьким?	Tu
Быть может, у нас не ценности разные, а отношение к этим ценностям?	Td
Быть может, этим всё и объясняется?	Tu
В Германии или Англии?	Tu
В Екатеринбурге?	Tu
В Марий Эл бездорожье вообще исчезнет?	Tu
В Норвегию?	Tu
В России будут отмечать День отца?	Td
В России ей неинтересно?	Tu
В бизнесе?	Tu
В большой группе талантливых, с которыми работает?	Tu
В войне с Финляндией?	Tu
В городе желтуха?	Tu
В его философии?	Tu
В интернат?	Tu
В искусстве важно как, а не что, правда?	Tu
В каких классах пройдёет эксперимент?	Td
В каких случаях копирайт необходим?	Tu
В каких странах 70% преступников в тюрьмах мусульмане?	Td
В каких сферах он применяется?	Td
В какой аппликации открыть этот файл?	Td
В каком ключе они обсуждают происходящее?	Td
В каком родстве вы состоите?	Tu
В камеру опять?	Td
В конце концов, почему бы нет?	Td
В котором часу дом запирается?	Td
В котором часу начинается матч?	Td
В котором часу нужно освободить номер?	Td
В котором часу он придёт?	Td
В котором часу?	Tu
В кремль?	Tu
В курсе, молодой пенсионер, когда Алиев в Коломну приезжал?	Td
В лягушатник можно ходить с годовалым ребёнком?	Td
В младенчестве, что ли?	Td
В наших агрессия?	Tu
В ногу со временем?	Tu
В номере есть кондиционер?	Tu
В общем, стоит ли овчинка выделки?	Tu
В пакете?	Tu
В перспективе атом?	Tu
В подземном переходе?	Tu
В самом деле, кто сможет сюда заглянуть?	Td
В свете сказанного, не совсем понятно, зачем Вы сообщили о 8 миллионах русских в Украине?	Tu
В сезон отель забит?	Tu
В сметане?	Tu
В смысле, за что платим?	Tu
В смысле, сократил зачем?	Tu
В стоимость аренды включено топливо?	Tu
В такой час?	Tu
В течение какого времени я могу вернуть машину?	Td
В том числе, для движения против коррупции и других моментов?	Tu
В футболе вы вратарь, а в жизни?	Tu
В цену включено страхование гражданской ответственности автомобилистов?	Tu
В чем Вы видите, Владимир Владимирович, корень проблем?	Td
В чем ваш главный тезис?	Tu
В чем же выгода посещения интернет-магазинов?	Td
В чем же они заключаются?	Tu
В чем их военная необходимость?	Tu
В чем метафизика?	Tu
В чем опасность, на мой взгляд?	Tu
В чем специфика таких вложений?	Tu
В чем сущность шведов?	Tu
В чьей жизни сворачивается?	Td
В чьих умах и делах живёт имя вождя пролетариата?	Tu
В чьём государстве мы живём, русских или россиян?	Td
В чём вы собираетесь обвинить меня?	Td
В чём дело, спрашивается?	Td
В чём дело?	Tu
В чём духовность?	Tu
В чём же камень преткновения?	Td
В чём же фишка Google+?	Td
В чём их вина?	Td
В чём новизна?	Td
В чём подвох?	Td
В чём причина, на ваш взгляд?	Tu
В чём проблема?	Tu
В чём разница между нынешними российскими олигархами и украинскими?	Td
В чём суть гуманной педагогики?	Td
В чём счастье педагога?	Tu
В чём ты меня обвиняешь?	Tu
В штатном режиме?	Tu
В-третьих, что делать, если зафиксирован необоснованный рост цен?	Td
Вадим, о чем вы говорите?	Tu
Валерий Иванович объяснит?	Tu
Валерий Иванович, ну что за фигня?	Tu
Вам ещё чаю или кофе?	Td
Вам комфортно играть в российских спектаклях?	Td
Вам кто рецепт должен выписать?	Td
Вам не жарко?	Tu
Вам не холодно?	Tu
Вам пиво или что-нибудь покрепче?	Tu
Вам понравилось?	Tu
Вам приходит что-нибудь в голову?	Td
Вам это интересно?	Tu
Вам это подходит?	Tu
Вами занимаются?	Tu
Вас всех госпитализировали, согласно страховке?	Tu
Вас она шокирует?	Tu
Вас уже обслуживают?	Tu
Вас услышали, как думаете?	Td
Вас устраивает, как теперь власть защищает нас от террора, от убийств?	Tu
Василий, может его макнуть?	Td
Ваш идеал господина?	Tu
Ваш идеал госпожи?	Tu
Ваш идеал раба?	Tu
Введут штрафы?	Tu
Вдруг меня не знаешь?	Tu
Ведь вроде так, или я ошибаюсь?	Td
Ведь для МЕНЯ пишете?	Td
Ведь кому будет улыбаться фортуна, как не людям, чья жизнь напрямую связана с деревом?	Tu
Ведь кто, собственно, сделал выбор в пользу новых методик?	Td
Ведь нет разницы, ведь так?	Tu
Ведь судьба главного героя фильма не ясна?	Tu
Ведь там же не разрешают, наверное?	Tu
Ведь ты несовершеннолетняя, а за совращение подростков знаешь, что бывает?	Tu
Ведь у вас были как удачи, так и неудачи?	Td
Ведь явно не диссертация?	Td
Велика ли сумма?	Td
Верите?	Tu
Верно, инспектор?	Tu
Вернёмся ли мы когда-нибудь?	Tu
Весенний подъём уже репетиция?	Tu
Весь офисный планктон?	Tu
Взимается плата за аннулирование заказа?	Td
Взимается плата за резервирование номера?	Tu
Виден ли конец кризису?	Tu
Видите две руки?	Tu
Видите, как мы движемся к Европе?	Td
Видите, ключ поворачивается?	Tu
Виктор Степанович, откуда Вы взяли эти проценты?	Td
Виктор Степанович, что же это творится?	Tu
Включить свет?	Tu
Владимир Владимирович, знаете легенду про Менделеева?	Tu
Внедряют надолго?	Tu
Во время прогулки можно слушать аудиоэкскурсию?	Td
Во время прогулки можно сойти на берег?	Tu
Во сколько мне там быть?	Tu
Во сколько начинается сеанс?	Td
Во сколько начинаешь работать?	Td
Во сколько отъезд?	Tu
Во сколько подаётся завтрак?	Tu
Во сколько ты начинаешь работу?	Tu
Во сколько ты обычно встаёшь утром?	Td
Во сколько улетает мой самолёт?	Td
Во сколько уходит этот поезд?	Tu
Во сколько?	Tu
Во что?	Tu
Во-вторых, с чего вы решили, что вы честный человек?	Tu
Во-первых, как эти средства могут быть защищены от инфляции, экономических кризисов и прочих потрясений?	Tu
Водку в жару в пустыне из рюкзака пили когда-нибудь?	Td
Возможно, ему и надо отдать предпочтение?	Td
Возможно, стоит повременить?	Tu
Войны теперь захотелось?	Td
Волгоград уже вылетел из мундиаля?	Td
Вон на берегу теплушка, видишь?	Tu
Вопрос где ФСБ и ФСО?	Tu
Вопрос исчерпан?	Tu
Вот как это возможно?	Tu
Вот кто её придумал, войну?	Td
Вот представьте, если это произойдёт?	Tu
Вот скажи, у тебя в жизни был случай, когда тебе взял и помог посторонний, чужой человек?	Tu
Вот хоть мой взять, верно?	Tu
Вот что заебало?	Td
Вот что, вот это всё, что вы нам рассказали, значит для домохозяйки непосредственно?	Tu
Вот, как это соотнести?	Td
Впрочем, много ли их оставалось?	Td
Впрочем, чему удивляться?	Tu
Впрочем, что тут удивительного?	Tu
Временной отрезок?	Tu
Вроде бы одни плюсы?	Tu
Врут, наверное?	Tu
Все ещё в поиске инвесторов?	Tu
Все на ней ездят, а она молчит?	Tu
Все под банкротство?	Tu
Все справились?	Tu
Всерьёз?	Tu
Всех интересуют, вырастут ли цены на лекарства?	Tu
Вспомните, что хотела инфляция?	Tu
Встретиться с ними лицом к лицу, поговорить?	Tu
Встреча ещё в силе?	Tu
Всю вину на жену?	Tu
Всё взяли, ничего не забыли?	Tu
Всё отремонтируют?	Tu
Всё прозрачно, может согласимся?	Tu
Всё, все довольны?	Tu
Вы агент?	Tu
Вы будете ещё заказывать?	Td
Вы будете к этому картофель фри?	Tu
Вы будете платить наличными или кредитной карточкой?	Td
Вы бы хотели на каком языке?	Tu
Вы в думу обращались о нехватке ассигнований?	Tu
Вы в каких родственных отношениях?	Td
Вы в судьбу верите?	Tu
Вы ведь не исключение?	Tu
Вы верите в Бога?	Td
Вы взимаете комиссию?	Tu
Вы видели людей, их подписи?	Tu
Вы говорите по-английски?	Tu
Вы дадите нам интервью?	Td
Вы далеко проживаете?	Td
Вы дебилы?	Tu
Вы думаете, у них всплеск позитивных эмоций?	Tu
Вы думаете, это всё?	Tu
Вы еврей?	Tu
Вы его чувствуете?	Tu
Вы её почувствовали?	Tu
Вы ждёте от меня сравнений?	Tu
Вы же были в Ленинграде?	Tu
Вы же не любите, когда вас используют?	Td
Вы живёте в блочном или семейном доме?	Tu
Вы живёте одной семьёй?	Tu
Вы заинтересовались?	Tu
Вы записаны на приём?	Td
Вы здесь ориентируетесь?	Tu
Вы здесь первый раз?	Tu
Вы здесь принимаете эти чеки?	Td
Вы здесь уже когда-нибудь были?	Tu
Вы знаете друг друга?	Tu
Вы знаете какие-нибудь иностранные языки?	Td
Вы знаете мою жену?	Td
Вы знаете про бизнес-ангелов?	Td
Вы знаете, как смеются ангелы?	Td
Вы знаете, что сейчас сезон гриппа?	Tu
Вы знакомы?	Tu
Вы из чьих будете?	Td
Вы имеете в виду, инновационную промышленность?	Tu
Вы искали везде?	Tu
Вы исправите мне дырявую шину?	Td
Вы как верховный главнокомандующий, что бы сказали семьям погибших?	Tu
Вы когда-нибудь видели Бродского?	Td
Вы комсомолец?	Tu
Вы курите?	Tu
Вы любите фотографировать?	Tu
Вы меня заберёте?	Tu
Вы меня можете отпустить под залог?	Tu
Вы меня подвезёте?	Tu
Вы меня помните?	Tu
Вы меня поняли?	Tu
Вы меня узнаёте?	Tu
Вы мне верите?	Tu
Вы мне доверяете?	Tu
Вы мне не подскажете, когда мне выходить?	Td
Вы могли бы меня довезти к бензоколонке?	Tu
Вы могли бы мне помочь?	Tu
Вы могли бы мне это объяснить?	Td
Вы можете высказаться по этому поводу?	Td
Вы можете достать для нас билеты?	Td
Вы можете меня довезти в милицию?	Tu
Вы можете мне зарядить батарею?	Td
Вы можете мне показать, как это работает?	Td
Вы можете мне помочь выбраться из воды?	Td
Вы можете мне помочь?	Td
Вы можете мне сказать?	Tu
Вы можете мне это вернуть?	Td
Вы можете мне это завернуть?	Td
Вы можете мне это заменить?	Td
Вы можете мне это написать?	Td
Вы можете мне это отдать?	Td
Вы можете мне это поменять?	Td
Вы можете набрать этот номер?	Td
Вы можете нас познакомить?	Td
Вы можете отправить это снова?	Td
Вы можете переслать ему моё сообщение?	Td
Вы можете повторить это?	Td
Вы можете попросить его к телефону?	Tu
Вы можете снять с меня наручники?	Td
Вы можете уделить нам несколько минут?	Td
Вы можете это узнать?	Tu
Вы мозги имеете?	Tu
Вы настаиваете на этом?	Td
Вы нашли это без затруднений?	Tu
Вы не будете возражать, если я сяду здесь?	Td
Вы не исключение?	Tu
Вы не могли бы нам показать комнату?	Td
Вы не могли бы нам показать, где наша каюта?	Td
Вы не могли бы нас сфотографировать?	Td
Вы не могли бы показать нам город?	Td
Вы не можете мне найти такси?	Td
Вы не можете мне что-то вколоть?	Td
Вы не можете показать мне на карте, где мы находимся?	Td
Вы неглупый человек, у Вас хорошие гены отца и бабушки, так за чем эти статьи?	Tu
Вы организуете велопоездки?	Td
Вы ориентируетесь в Праге?	Td
Вы по делам или в отпуск?	Td
Вы подбросите меня до вокзала?	Td
Вы получили мой емайл насчёт?	Td
Вы получили наше письмо?	Tu
Вы понимаете по-английски?	Td
Вы правда геодезист?	Tu
Вы представите меня?	Tu
Вы представляете, какая это ответственность?	Td
Вы представляли себе объем фальсификаций?	Tu
Вы приедете за мной?	Td
Вы принимаете какие-нибудь лекарства?	Td
Вы присоединитесь к нам?	Tu
Вы проверите мне это?	Td
Вы продаёте марки?	Td
Вы пьёте пиво?	Td
Вы пятьдесят евро не разменяете?	Tu
Вы работаете посменно?	Tu
Вы реально думаете, что это его, царя батюшки, дело?	Td
Вы с ней вместе писали, дружили?	Tu
Вы с сахаром?	Tu
Вы свободны?	Tu
Вы себе представляете?	Tu
Вы сидите удобно?	Tu
Вы скажете неожиданно?	Tu
Вы скажете, такое невозможно?	Tu
Вы скажете, что и это не более, чем лозунг?	Tu
Вы слышите меня?	Td
Вы сможете достать нам билеты на завтрашний вечер?	Td
Вы совершили ошибку?	Td
Вы согласны?	Td
Вы спросите, а что же четвёртый?	Tu
Вы спросите, где же связь между информационными технологиями и боевым искусством?	Td
Вы спросите, где же тут ошибка?	Tu
Вы спросите, зачем весы?	Tu
Вы считаете это нужным?	Tu
Вы сыты?	Tu
Вы требуете какую-нибудь квалификацию?	Tu
Вы тренируетесь регулярно?	Tu
Вы уверены, что здоровы?	Td
Вы удовлетворены?	Tu
Вы уже говорили об этом?	Td
Вы уже заказали?	Tu
Вы умеете говорить на английском?	Td
Вы умеете пользоваться компьютером?	Td
Вы устали, читатели?	Td
Вы хорошо видите, что смотрят ваши дети по телевидению, уж не говорю об интернете?	Td
Вы хотели пошуметь?	Tu
Вы хотели экспертизу, чтобы доказать дееспособность?	Tu
Вы хотите ещё?	Tu
Вы хотите оставить ему сообщение?	Tu
Вы хотите создать семью?	Td
Вы хотите что-нибудь добавить?	Td
Вы хотите что-нибудь ему передать?	Td
Вы хотите, чтобы я вас ждал в аэропорту?	Tu
Вы член Конгресса и имеете информацию изнутри?	Tu
Вы что, медведя испугались?	Tu
Вы чувствуете себя хорошо?	Tu
Вы это не знаете?	Tu
Вы это поняли?	Td
Выдержит ли кошелёк собственника?	Tu
Выключить компьютер?	Tu
Выходит, жить среднему классу стало лучше?	Tu
Выходит, умышленно пытались людей обмануть?	Td
Выходит, что и в подвале курить будет нельзя?	Td
Выходит, чтобы ноги не протянуть?	Tu
Вячеслав, а за что Вы меня блокировать собрались?	Td
Вячеслав, а кто ответит за 10 убитых преступниками полицейских?	Td
Вячеслав, а сам не хочешь съездить на Майдан?	Tu
Вячеслав, вы работаете?	Tu
Вячеслав, как сербы сегодня относятся к России?	Td
Вячеслав, сам писал, или помогли?	Tu
Гараж в собственности, а земля?	Tu
Где Иосиф Виссарионович?	Td
Где ближайшая авторемонтная мастерская?	Tu
Где ближайший почтовый ящик?	Td
Где ближайший телефонный автомат?	Td
Где был бы сейчас Квебек?	Td
Где вагон-ресторан?	Td
Где вам больно?	Td
Где вас высадить?	Td
Где взять время, чтобы всё успеть?	Td
Где взять финансы?	Tu
Где вы были?	Td
Где вы живёте?	Td
Где вы познакомились?	Tu
Где вы проведёте отпуск?	Td
Где вы с ним познакомились?	Td
Где вы сейчас находитесь?	Td
Где вы учились?	Td
Где вы, чудо дворцы?	Td
Где выход на первую платформу?	Td
Где грань дозволенного?	Td
Где грань?	Td
Где гуманизм?	Tu
Где ж друзья, твои ровесники?	Tu
Где же ещё?	Td
Где же здесь наслаждение?	Td
Где же инновации?	Tu
Где журналистские расследования?	Tu
Где зафиксированы эти коэффициенты?	Td
Где здесь ближайшая больница?	Td
Где здесь ближайший кемпинг?	Td
Где здесь интернет-кафе?	Td
Где здесь магазин косметики?	Td
Где здесь могу позаниматься в тренажёрном зале?	Td
Где здесь можно арендовать автомобиль?	Td
Где здесь можно припарковать машину?	Td
Где здесь находится станция метро?	Td
Где здесь находится стильная пивная?	Td
Где здесь несоответствие?	Tu
Где здесь принтер?	Tu
Где здесь туалеты?	Td
Где измена?	Td
Где касса?	Td
Где крыша?	Tu
Где лежат гигиенические пакеты?	Td
Где логика, Дмитрий?	Tu
Где логика, спрашивается?	Td
Где лучше жить в городе или в деревне?	Td
Где лучшее место для рыбалки?	Td
Где место для стула?	Tu
Где мне взять тряпку и ведро?	Tu
Где мне прокомпостировать билет?	Td
Где можно заказать обзорную экскурсию?	Tu
Где можно купить билеты?	Td
Где можно купить?	Tu
Где можно найти?	Tu
Где можно оставить лыжи?	Td
Где можно помыть руки?	Td
Где можно припарковать автомобиль?	Td
Где мозг, где чувства?	Tu
Где моё волшебство?	Tu
Где мы встретимся?	Tu
Где мы можем поставить палатку?	Td
Где на борту пункт обмена валюты?	Td
Где на теплоходе туалеты?	Tu
Где найду какую-нибудь тряпку для пола?	Td
Где найти автомат по продаже билетов?	Td
Где находится ближайшая бензоколонка?	Td
Где находится ближайший вокзал?	Td
Где находится домкрат?	Tu
Где находится камера хранения?	Td
Где находится пункт упаковки багажа в стрейч плёнку?	Td
Где находится распределительный шкаф?	Td
Где находится ресторан гостиницы?	Td
Где наше самоуважение?	Tu
Где обдуманный подход к местным кадрам, вами же обещанный?	Td
Где обещанный Центр?	Td
Где обещанный властями эффект?	Tu
Где он учится?	Td
Где он?	Td
Где она, эта рука России?	Td
Где они взяли шестнадцать тысяч колёс?	Td
Где они, в каких отраслях?	Tu
Где пенсионеру хорошо?	Td
Где появится Аллея России?	Td
Где правда, брат?	Td
Где правда, где справедливость?	Tu
Где пригодилась?	Tu
Где примерочная кабина?	Td
Где припарковать нашу машину?	Td
Где продают билеты?	Td
Где проходит регистрация?	Td
Где рожать и где лечить мою будущую внучку?	Tu
Где следы взрыва?	Td
Где справедливость, брат?	Tu
Где супругу встретили?	Tu
Где там идеология?	Td
Где твои дети?	Tu
Где теперь ориентиры профессионализма?	Tu
Где тогда дьявол?	Tu
Где требовать компенсацию за утерянный багаж?	Td
Где тут недалеко бензоколонка?	Td
Где тут поблизости продовольственный магазин?	Td
Где ты взял это?	Td
Где ты застрял?	Td
Где ты научился этому?	Td
Где ты хочешь сесть?	Td
Где у вас солнцезащитные кремы?	Td
Где у нас главком?	Td
Где уж тут до планов на дальнейшую жизнь?	Td
Где учитесь, работаете?	Td
Где эти бумаги?	Tu
Где эти порядки?	Td
Где это было?	Td
Где это видано?	Tu
Где это можно купить?	Tu
Где это произошло?	Td
Где это?	Td
Где я могу за это заплатить?	Td
Где я могу получить багаж?	Td
Где я могу получить возврат НДС?	Td
Где я сделал ошибку?	Td
Где я совершил ошибку?	Td
Генерального, меня и себя?	Tu
Гениально, да?	Tu
Геннадий Поляков, pазве узнаешь по фото, что это гараж?	Tu
Геологи есть?	Tu
Герой или злодей?	Td
Герцог, говорите?	Tu
Главы района ведут себя неадекватно, хотя почему?	Tu
Гнездо строили?	Td
Говорите, куда ехать?	Tu
Говорить ли ребёнку о диагнозе?	Td
Говоришь, что не знаешь её совсем?	Td
Говорят на немецком, ну и что?	Tu
Годовщина преступления?	Tu
Голову повесил?	Td
Голоден ты?	Td
Гордыня не позволяет?	Tu
Город Феникс?	Tu
Город, село?	Tu
Господа, вы и вправду верите тому, что пишете?	Tu
Господа, зачем преувеличивать?	Tu
Готов съездить, только кто за рулём?	Tu
Готовились стать инженером?	Tu
Готовы ли к труду и обороне, к серьёзным испытаниям, наконец?	Td
Граждане мигранты, вы не забыли, что вы тут в гостях?	Tu
Греха уныния искус?	Td
Григорий Семенович, как ваша операция?	Td
Грозит ли России дефолт?	Tu
Грозит ли это реальными проблемами пассажирам-льготникам?	Td
Грудью встанем?	Td
Грядущий юбилей по тем же правилам?	Tu
Да вы чё, парни?	Td
Да за что же, господи?	Td
Да и где он, Сергей Александрович?	Tu
Да и где он, тот лось?	Td
Да и где хор из 30 человек, детская группа хора?	Td
Да и нужны ли городу, да и самим выпускникам, эти специальности?	Tu
Да и такой ли уж безнравственный?	Tu
Да и, в конце концов, как нововведение затронет рядовых автовладельцев?	Tu
Да как вы смеете?	Tu
Да кто ж теперь вспомнит?	Td
Да, есть ли плюсы?	Tu
Да, раньше были и у подъездов были, а сейчас?	Tu
Да?	Tu
Давай останемся друзьями?	Td
Даже в амбициях?	Tu
Даже из самых благих намерений?	Tu
Даже на секунду?	Tu
Даже о космосе, что ли, никто не мечтает?	Td
Дама с характером?	Tu
Дачи или участки для многодетных?	Tu
Даёшь слово?	Td
Две тысячи печей сложил?	Td
Девушка, вы вечером свободны?	Tu
Дед и отец рассказывали про ГУЛАГ?	Tu
Действительно ли блондинка, а может, всё же шатенка или брюнетка?	Tu
Действительно, а зачем такие суммы перечислять одной организации?	Tu
Действительно, что им ещё оставалось?	Tu
Действительно?	Tu
Делаем ставки, господа?	Td
Денис, а вы читали их требования?	Tu
Деньги зарабатывала?	Td
Деньги?	Tu
Деревянный, неужели букварь в руки взял?	Tu
Держать пост, молиться и идти в храм?	Tu
Детки в клетку?	Tu
Дефективный первоцвет, или Кто на живца прибежит?	Td
Джентльмен ли вы?	Td
Дискуссия закончена?	Tu
Для каких мышц предназначено это упражнение?	Td
Для кого увеличивать?	Td
Для нескольких пешеходов?	Tu
Для себя вы это объяснили?	Td
Для чего нужны рейтинги журналистов?	Td
Для чего он необходим?	Td
Для чего это нужно?	Td
Для чего это служит?	Td
Для этой дороги лучше иметь горный велосипед?	Tu
Дмитрий Анатольевич?	Tu
До какого времени ты работаешь?	Td
До какого срока должно быть это сделано?	Td
До какой степени?	Td
До момента, как я увидел киоск с мороженым, я не мог понять, чем ещё утолить жажду?	Tu
До свидания, деньги?	Tu
Доверяет, кому?	Tu
Долги не уменьшаются?	Tu
Должен ли врач сесть в тюрьму?	Tu
Доллар вырос на 30%, а чем хуже крупа и макароны?	Td
Доллар, евро или всё же рубль?	Tu
Допустим, но каков эквивалент убийства?	Tu
Достали родственники?	Tu
Доступен ли он в университетских библиотеках?	Td
Дрожь земли?	Tu
Другое дело, на что он способен, этот состав?	Td
Другой вопрос есть ли у нас, у государства, культурная политика?	Td
Другой вопрос, реально ли деньги взыскать?	Td
Другой способ предложен кем-либо?	Td
Думаете, они не в курсе?	Tu
Думаете, это известный овощ?	Td
Думаете, это невозможно?	Tu
Думаешь, стоит?	Tu
Дымом дышать будем?	Td
Дядя, а вы в какой стране живёте?	Td
Евгений Владимирович, как вы попали в группу медиков, работающих в Африке?	Tu
Египетский сценарий?	Tu
Екатерина, солнышко, дело в цвете и марке машины?	Tu
Ему что-нибудь передать?	Tu
Если бы я пришёл, ты бы мне заплатил?	Tu
Если всю жизнь с техникой?	Td
Если человек лежачий, а сиделка ушла в магазин на полчаса?	Td
Если человек, например, попал в больницу в день переписи или уехал в срочную командировку?	Tu
Если это не геноцид, то что?	Td
Есть в библиотеке публичный Интернет?	Td
Есть в этом логика, согласитесь?	Tu
Есть возможность взять холодильник напрокат?	Td
Есть где-то поблизости аквапарк?	Td
Есть дым без огня?	Tu
Есть здесь где-нибудь пункт проката лыж?	Td
Есть здесь какой-нибудь аэропорт поближе?	Td
Есть здесь место с видом на город?	Tu
Есть здесь общественные туалеты?	Td
Есть здесь по близости бассейн или купальня?	Td
Есть здесь поблизости аптека?	Td
Есть здесь поблизости велосипедные дорожки?	Td
Есть здесь поблизости какая-то смотровая площадка?	Td
Есть здесь трассы для начинающих?	Td
Есть какие-нибудь побочные действия?	Td
Есть какие-нибудь предложения?	Tu
Есть ли будущее у симпозиума?	Td
Есть ли в России офицеры?	Td
Есть ли где-нибудь поблизости больница?	Tu
Есть ли ещё свободные места на сегодняшний рейс?	Td
Есть ли исключения?	Td
Есть ли рецепты, как его преодолить?	Td
Есть ли такие люди, на ваш взгляд, сейчас в Академии?	Tu
Есть ли тут поблизости заправка?	Tu
Есть ли у вас и такая сверхзадача?	Tu
Есть ли хоть кто-нибудь, работающий над тем, чтобы хотя бы описать происходящее?	Tu
Есть свободные стулья?	Td
Есть у вас доступ в Интернет?	Tu
Есть у вас другой цвет?	Td
Есть у вас какое-нибудь средство от морской болезни?	Td
Есть у вас что-нибудь похожее?	Td
Есть у тебя ещё другой?	Tu
Есть у тебя сейчас время?	Td
Есть что-нибудь нового?	Td
Ещё вина?	Tu
Ещё играешь в баскетбол?	Td
Ещё идёт дождь?	Td
Жалко разве?	Td
Жгут или не жгут?	Tu
Ждать ли каких-то перемен?	Td
Женская психология?	Tu
Жертвы поэзии?	Tu
Живы ли ещё ваши родители?	Td
Жизнь налаживается?	Tu
Жила в своё удовольствие?	Tu
Жить будет негде?	Tu
Журналист был удивлён, спросил, а что, нужен специальный навык?	Tu
Журналы и газеты?	Tu
За друзьями разве успеешь?	Tu
За кого она выходит?	Td
За кого ты болеешь?	Td
За кого ты меня принимаешь?	Td
За мизерную зарплату?	Tu
За сколько времени до отплытия начинается регистрация?	Td
За счёт кого, думаете?	Tu
За то, чтобы бумажку переписать?	Tu
За чей же счёт гуляем, господа?	Td
За чей счёт их содержать, откуда взять деньги на них?	Tu
За чей счёт они ездили?	Td
За чей счёт экономия?	Tu
За что погиб Борис Немцов?	Td
Забыли какую муть и грязь вы, журналисты, несли в 90-е?	Tu
Забыли, наверное?	Tu
Забыли, что в рейс?	Tu
Забыть оскорбления?	Tu
Завтра у тебя выходной?	Tu
Завтрак включён в цену?	Td
Задаток возвращается?	Tu
Задумался где взять сюжеты?	Td
Законные противоречия, или Экзекуция по Конституции?	Tu
Закономерный триумф?	Tu
Закупили у китайцев?	Tu
Заряжать ноутбук на работе?	Td
Зачем Вы меня задержали?	Td
Зачем Украине парламент?	Td
Зачем бизнесу культура?	Td
Зачем вообще нужен литературный истеблишмент?	Tu
Зачем вы записывали?	Td
Зачем выходили?	Td
Зачем делать избирком муниципальным?	Tu
Зачем для себя же гадить?	Td
Зачем же болтать попусту?	Td
Зачем же возить с собой лишнюю тяжесть?	Td
Зачем же им собирать подписи, когда их проверял министр?	Tu
Зачем же нужна философия?	Tu
Зачем класть асфальт в лужи?	Td
Зачем навязываться?	Td
Зачем нам, налогоплательщикам, их кормить и одевать годами, да ещё и строить для них новые тюрьмы?	Td
Зачем напрягаться?	Tu
Зачем он ему это сказал именно сейчас?	Td
Зачем оппозиция?	Td
Зачем отдыхать?	Tu
Зачем переучиваться?	Tu
Зачем приезжали?	Tu
Зачем пришёл?	Tu
Зачем растягивать?	Tu
Зачем реагировать, нервы портить?	Tu
Зачем слушать?	Td
Зачем ставить штамп?	Td
Зачем тебе туда ходить?	Td
Зачем терять время?	Td
Зачем ты её пригласил?	Tu
Зачем ты это сделал?	Tu
Зачем форум нужен сегодня?	Tu
Зачем хранить?	Td
Зачем, Александр Александрович?	Td
Зачем, думала теперь она, зачем я с собой так?	Tu
Зачем, кстати, нужна рота, состоящая сплошь из командиров?	Tu
Зачем, спрашивается?	Td
Здесь возможно навещать больных?	Td
Здесь где-нибудь поблизости имеется торговый центр?	Td
Здесь есть вблизи хороший и недорогой ресторан?	Td
Здесь есть где-нибудь нудистский пляж?	Td
Здесь же дорогая земля, неужели никого не интересует?	Td
Здесь иллюзия чего?	Tu
Здесь кто-нибудь есть?	Tu
Здесь можно взять напрокат зонт?	Td
Здесь можно голосовать?	Tu
Здесь можно купить карту велосипедных дорожек?	Td
Здесь можно курить?	Tu
Здесь можно найти ночлег в частном секторе?	Td
Здесь можно разбить палатку?	Td
Здесь можно развести костёр?	Tu
Здесь можно фотографировать?	Td
Здесь платный вход?	Tu
Здесь свободно?	Tu
Здесь хорошее место для безопасных погружений?	Td
Знаете, в чём он ошибся?	Tu
Знаете, о ком речь?	Td
Знаете, почему терпели?	Td
Знаешь русский лучше всех?	Tu
Знаешь, где живём?	Tu
Знаешь, зачем?	Tu
Знаешь, чего я боюсь?	Tu
Значит ли это, что я ксенофоб?	Tu
Значит с завтрашнего дня через неделю?	Tu
Значит, а в чём же здесь, собственно, Бог?	Tu
Значит, и у нас можно обойтись без господдержки?	Tu
Значит, моральный ущерб Альберт Викторович нанёс сам себе?	Tu
Значит, мы пока ещё очень бедные?	Tu
Значит, не всё ещё потеряно?	Tu
Значит, такой чиновник наносит вред государственности?	Tu
Значит, теперь возвращаемся к этому полю, кто такой человек-мистик?	Tu
Знают ли жителей своих районов, малоимущих и их нужды?	Td
И Гитлера нельзя убивать?	Td
И в чём же мудрость?	Tu
И вам, нежно мной любимый и уважаемый, но тоже далёкий от церкви Андрей Петрович?	Tu
И вдруг устарел?	Tu
И вина ли автора, что, раз от раза не находя понимания, он ищет пути к диалогу?	Tu
И вообще у меня все книги шли, знаешь, с каким трудом?	Tu
И вообще, в каком вы имеете в виду смысле?	Td
И вообще, один ли и тот же человек это определяет?	Td
И вот таких ещё земля носит?	Tu
И вся ваша торговля незаконная?	Tu
И всё же, что это такое, женская дружба?	Td
И где Федя мой теперь?	Tu
И где ж обещанный порядок в ЖКХ?	Td
И где обещанный механизм компенсации?	Tu
И да, на год текущий посмотрите, чай не 1937-ой?	Td
И даже с каких, собственно, позиций она может выступить?	Td
И если да, то зачем, раз оно и так в собственности?	Td
И ещё, а остров Русский наш?	Tu
И ещё, можно сделать логотип побольше?	Tu
И жизнь сама-по себе сразу улучшится?	Tu
И знаешь, почему?	Tu
И им всё позволено?	Tu
И как же побороть коррупцию, например, в России?	Tu
И как нам сделать суды независимыми?	Td
И как определить ту единственную, идеальную?	Tu
И как так получилось, что российский рынок не вошёл в число счастливчиков, где авто представлено официально?	Tu
И как успехи?	Tu
И каков же был итог?	Td
И каково оно, если говорить откровенно, между нами, юристами?	Tu
И кому тут давать преференции?	Td
И кто победит?	Td
И кто эти люди, которых сегодня обвиняют в трагедии?	Td
И куда делись эти две тысячи?	Td
И не обсуждались?	Tu
И нести убытки?	Tu
И о каком, вообще, развитии спорта здесь может идти речь?	Td
И победила в итоге, получается?	Tu
И потом что?	Td
И почему бы, скажем, не в модуль конструктора?	Tu
И почему они лишены?	Tu
И почему они теперь советуют их всем своим знакомым, родственникам и друзьям?	Td
И поэтому она от него ушла?	Tu
И правда, какая Пасха без яиц?	Td
И правда, чего я сижу?	Tu
И при каких тут делах толерантность?	Td
И раз уж ты самодержец, не всё ли равно?	Tu
И решили торговать землёй?	Tu
И с чего Вы взяли, Василий, что я переживаю из-за Януковича?	Tu
И с чего решили, что я радуюсь?	Tu
И сколько в нынешнем году первоклассников?	Tu
И смогли бы вы вспомнить о них, не будь футбола?	Td
И спросили, поедем ли в больницу?	Tu
И сразу вопрос, а где ещё доказательства, кроме десантников?	Td
И уж тогда купили бы один корабль, а четыре зачем?	Td
И хоть что-нибудь из того, что обещал, он выполнил?	Tu
И чем закончилось?	Tu
И чем человек полезен для друзей?	Tu
И что в этом плохого?	Tu
И что вы думаете, чем занялись предприниматели?	Tu
И что другие люди?	Td
И что ждёт пассажиров в ближайшем будущем?	Td
И что они из себя представляют?	Tu
И что особенного?	Td
И что остальное?	Tu
И что с тех пор изменилось?	Td
И что хотел сказать, почему любят Интернет и не любят радио и телевидение?	Tu
И что, будем теперь только шубу лопать, как моль?	Tu
И что, вся надежда на алкоголиков?	Tu
И что, лагерь тогда просто закроют?	Tu
И что, призывник должен за них погибнуть?	Tu
И что, теперь этим родителям не ездить на маршрутках?	Tu
И что, это единственные экземпляры?	Tu
И что?	Tu
И это бесспорно?	Tu
И это всё?	Tu
И, может, тогда увидим свет в конце тоннеля?	Tu
И, наконец, разве Россия объявила планету Земля сферой своих интересов?	Tu
Ибо какой тут детский сад, когда с утра у ребёнка ритмика, после обеда логопед, вечером бассейн?	Tu
Иван, а зачем бордюры то сносить?	Tu
Иглоукалывание, говорите?	Tu
Игорь, а что, Болгария лучше в плане партнёрства?	Td
Из того, что она взяла название?	Tu
Из чего это сделано?	Td
Извините, а как же остальные?	Tu
Извините, я вас не беспокою?	Tu
Извиняться будем?	Tu
Изменились жизненные обстоятельства?	Tu
Изменился ли за эти годы налогоплательщик?	Tu
Или беднее?	Tu
Или в Ташкенте?	Tu
Или весь мир врёт?	Tu
Или вполне логично?	Tu
Или все-таки рискнуть?	Tu
Или доверчивый?	Tu
Или его ангажированность?	Tu
Или же, напротив, мне научиться от них чему-то?	Tu
Или и то, и другое, и третье вместе?	Tu
Или намёк на вызов?	Tu
Или негров, живущих в Европе?	Tu
Или непонятна?	Tu
Или о той, к которой вернулись?	Tu
Или плохие очки?	Tu
Или позавчера?	Tu
Или поэтому плохие?	Tu
Или предположение?	Tu
Или с крупных магазинов проще дань собирать, чем с тысяч мелких?	Tu
Или секретный?	Tu
Или сестра человек нетрудоспособный?	Td
Или тебе так, лишь бы брякнуть?	Tu
Или уже всего достигли?	Tu
Или что у нас в стране, действительно, нет журналистики?	Tu
Или что, ждать пока ещё пара детей погибнет?	Tu
Или что-нибудь ещё?	Tu
Или что-то совершенно невероятное?	Tu
Или это дружественный обмен?	Tu
Или, в самом деле, что-то из области психологии?	Tu
Им что, вдвоём куковать?	Tu
Имейте совесть?	Tu
Имеются у вас скидки для групп?	Tu
Иначе говоря, нет ли здесь конкуренции?	Tu
Иначе, как этот дурдом объяснить?	Tu
Интересно, а за чей счёт он потом вывозится?	Tu
Интересно, а кто, находясь в полном здравии, напишет другое?	Tu
Интересно, в чьём же лице?	Td
Интересно, вот чем, чем думают эти люди, ну объясните же мне?	Tu
Интересно, как они, люди творческие, украшают дом и ёлки?	Tu
Интересно, как принимали в Чехии наших чемпионов?	Td
Интересно, куда же они подевались?	Td
Интересно, о чём чёрт сообщает?	Tu
Интересно, что он ответит?	Td
Интернет, услугу или роуминг?	Tu
Иными словами, что такое феноменология?	Tu
Исследователь культуры?	Tu
Исторический, к примеру?	Tu
Итак ем мерить цикл, чем мерить колебания?	Tu
Итак, вы считаете себя плотником?	Tu
Итак, как меняется рынок инжиниринга?	Td
Итак, перед нами вопрос, был ли он виновен в этом?	Td
Итак, что же мы видим?	Td
Итак, что же мы увидим?	Tu
Итак, что мы получаем?	Td
Их здесь нет, зачем ты вообще передачу эту взял?	Td
Их поездки оказались результативными?	Tu
Их результат, говорите?	Tu
Ищут пожарные, ищет милиция?	Tu
К жене и детям?	Tu
К какому виду относить это растение?	Td
К какому компьютеру я могу садиться?	Td
К какому окошку мне подойти?	Td
К кому ты примкнёшь?	Td
К объединению субъектов?	Tu
К разрушению русских исторических святынь, церквей и памятников?	Tu
К уничтожению русских книг в украинских библиотеках?	Tu
К чему ведёт эта конкуренция?	Td
К чему готовились?	Tu
К чему истерика в комментариях?	Tu
К чему их изобретать?	Tu
К чему стремился постановщик?	Td
К чему это?	Td
К этому прилагается также карта памяти?	Tu
Каждый день, в каждом дворе не по силам, невозможно?	Tu
Кажется, полет Юрия Гагарина?	Tu
Кажется, что тут необычного?	Tu
Казалось бы, о чём здесь мечтать?	Td
Казалось бы, при чем тут Лужков?	Tu
Казалось бы, чем же тут гордиться?	Td
Казалось, чего уж больше желать?	Td
Как Пушкин попал в библиотеку?	Td
Как беду обернуть в победу?	Td
Как будете платить?	Td
Как бы вы видели специфику?	Tu
Как бы вы его сформулировали?	Tu
Как бы ты описал это?	Td
Как быть с такими?	Tu
Как быть со справедливостью?	Td
Как в России упорядочить ценообразование?	Tu
Как в данном случае избежать конфликтов?	Td
Как в это играть?	Td
Как вам это понравилось?	Tu
Как вам это пришло в голову?	Tu
Как вас зовут?	Tu
Как вернуть кресло в исходное положение, пожалуйста?	Td
Как вести себя людям, оказавшимся в заложниках?	Td
Как взять Берлин?	Tu
Как вкусно повысить иммунитет?	Td
Как вы боретесь с терроризмом?	Td
Как вы доехали?	Tu
Как вы друг друга нашли, вновь везение на талантливых?	Tu
Как вы думаете, есть между ними связь?	Td
Как вы думаете, это реалистично?	Tu
Как вы к ним относитесь?	Td
Как вы на это смотрите?	Td
Как вы считаете, арест связан с этим расследованием?	Tu
Как вы считаете, это необходимо?	Tu
Как вы чувствуете, сможем ли мы использовать нынешний кризис в благих целях?	Td
Как выводить себя из депрессии?	Td
Как выглядел наш кемпинг?	Tu
Как далеко до Каира?	Tu
Как далеко пешком идти?	Tu
Как дальше?	Tu
Как дела складываются?	Td
Как добраться до подъёмника?	Td
Как дожить до бессмертия?	Td
Как долго будет длиться лечение?	Td
Как долго будет длиться поиск утерянного багажа?	Td
Как долго вы здесь останетесь?	Td
Как долго вы меня будете задерживать?	Td
Как долго вы меня здесь будете задерживать?	Td
Как долго вы там уже работаете?	Tu
Как долго вы уже здесь?	Td
Как долго вы уже знакомы?	Td
Как долго длится идти туда пешком?	Td
Как долго длится перевод?	Td
Как долго длится этот фильм?	Td
Как долго здесь живёшь?	Tu
Как долго мне ждать?	Td
Как долго мне придётся ждать пересадки?	Td
Как долго мне хватает кислорода?	Td
Как долго мы будем под водой?	Td
Как долго мы ещё поедем?	Td
Как долго они вместе?	Tu
Как долго ты ещё будешь?	Td
Как долго это будет длиться?	Td
Как долго это будет продолжаться?	Tu
Как долго это длится?	Td
Как думаете, почему?	Td
Как думаешь, соглашаться?	Tu
Как его звали?	Tu
Как его квалифицировать?	Td
Как же бизнесменам покрыть дефицит средств?	Td
Как же купить купальник по фигуре?	Td
Как же могила, и без креста?	Tu
Как же мы определяем, что хорошо, а что плохо?	Td
Как же он создавался?	Tu
Как же оформить медицинскую книжку легально?	Td
Как же получилось, что теперь аптека на грани банкротства?	Td
Как же проституция, наконец?	Tu
Как же так?	Tu
Как живём, спрашиваете?	Tu
Как жизнь идёт?	Td
Как жилось нам, нашему городу, региону, стране от понедельника до воскресенья?	Td
Как и где их искать, чему учить в школе?	Td
Как идут дела в колхозе?	Tu
Как идут наши дела?	Td
Как избежать неприятностей?	Tu
Как избежать неудач при выращивании?	Tu
Как избежать неудач при её выращивании?	Tu
Как им это может нравиться?	Td
Как лучше хлеб испечь?	Tu
Как мне выделить текст?	Td
Как мне ехать дальше?	Td
Как мне знать?	Tu
Как мне об этом знать?	Td
Как мне попасть в аэропорт?	Td
Как мне попасть в?	Td
Как мне это использовать?	Td
Как мне это понимать?	Td
Как мне это принимать?	Tu
Как называется вон та гора?	Tu
Как называется следующая остановка?	Td
Как называется следующая станция?	Td
Как называется эта остановка?	Tu
Как называется эта улица?	Td
Как называется эта фирма?	Td
Как нам добраться до паромной пристани?	Td
Как нам попасть на другой берег реки?	Td
Как например?	Td
Как настроить макрорежим?	Td
Как насчёт пива?	Tu
Как обезопасить ребёнка, находящегося в салоне автомобиля?	Tu
Как обезопасить себя от туберкулёза?	Tu
Как обстоит дело?	Td
Как обязать дочь, мою сестру, заботиться о матери?	Td
Как она выглядит?	Td
Как она держалась?	Tu
Как они об этом узнали?	Tu
Как отличить натуральную кожу от подделки?	Td
Как повысить эффективность антивирусов?	Td
Как подготовить теплицу к зиме?	Td
Как поживает ваша жена?	Td
Как поживаете?	Tu
Как поладить с соседями?	Tu
Как получилось, что перешли к прозе?	Td
Как помочь беженцам?	Td
Как помочь дочке?	Td
Как помочь ребёнку сосредоточиться?	Td
Как попасть на публичный пляж?	Td
Как попасть на стадион?	Td
Как произносится это слово?	Tu
Как распознать поддельные деньги?	Td
Как сделать жильё доступнее?	Tu
Как себя обезопасить?	Tu
Как сейчас они выглядят?	Tu
Как совместить?	Td
Как справляетесь?	Tu
Как стать полицейским?	Tu
Как твои дела?	Tu
Как тебе тогда можно верить?	Td
Как тебя зовут?	Td
Как тут колдовать, чтоб на всё хватило?	Td
Как ты без меня, любимая?	Tu
Как ты к этому пришёл?	Tu
Как ты можешь быть так уверен?	Td
Как ты можешь от этого получать удовольствие?	Td
Как ты на это смотришь?	Td
Как ты поступишь с этими деньгами?	Td
Как ты себя чувствуешь?	Td
Как ты это переносишь?	Td
Как у тебя дела?	Tu
Как у тебя с деньгами?	Tu
Как у тебя язык поворачивается такое говорить?	Td
Как уберечь детей, внуков?	Tu
Как хватило сил выдержать, выстоять, пережить всё это?	Tu
Как часто надо приходить на контрольные медосмотры?	Td
Как часто он сюда приходит?	Td
Как часто ты с ним встречаешься?	Td
Как часто ты туда ходишь?	Td
Как это будет выглядеть, скажем, в московских реалиях?	Tu
Как это было на самом деле?	Td
Как это взаимосвязано?	Tu
Как это выглядит?	Tu
Как это застёгивается?	Td
Как это к ним относится?	Td
Как это на тебя действует?	Tu
Как это пишется?	Tu
Как это произошло?	Tu
Как это сказать по-русски?	Td
Как это случилось?	Td
Как я вижу эту качественную государственность?	Tu
Как я мог знать об этом?	Td
Как я могу отблагодарить вас?	Td
Как, вы ещё не в курсе?	Tu
Как, говоришь, это случилось?	Td
Как, по-вашему, должна выглядеть схема взаимодействия с культурным наследием и интеллектуальной собственностью?	Tu
Какая будет погода?	Tu
Какая доплата за размещение с животными?	Td
Какая ещё Ассоциация?	Td
Какая идея следующая?	Td
Какая лучшая насадка для сома?	Td
Какая мне с этого прибыль?	Tu
Какая мощность у этой машины?	Td
Какая она?	Td
Какая погода ожидается сегодня?	Tu
Какая разница между этими двумя?	Tu
Какая разница, какой цвет у автомобиля?	Tu
Какая самая высокая гора в мире?	Td
Какая сегрегация, какие гетто в Советском Союзе?	Td
Какая страховка входит ещё в стоимость проката?	Td
Какая судьба ждёт проект?	Td
Какая цель вашего визита?	Td
Какая цена за один подъём?	Td
Какие были годы в тюрьме?	Td
Какие были оценки по русскому языку, физкультуре и музыке?	Tu
Какие встречи с избирателями?	Td
Какие грибы?	Td
Какие изъяны?	Tu
Какие меры безопасности?	Tu
Какие нарушения выявила Госавтоинспекция?	Td
Какие обследования мне нужны?	Td
Какие огурцы?	Tu
Какие победы, свершения?	Td
Какие права у покупателя интернет-магазинов?	Td
Какие против меня улики?	Td
Какие репрессии?	Td
Какие твои параметры?	Tu
Какие трассы можете рекомендовать для опытных лыжников?	Td
Какие тут дашь рекомендации?	Td
Какие у вас с ним отношения?	Td
Какие у вас фирменные блюда?	Tu
Какие у медведя игрушки?	Td
Какие у тебя планы на будущее?	Td
Какие уж тут разговоры?	Tu
Какие условия труда?	Tu
Каким будет техосмотр?	Td
Каким бы вы хотели видеть образ Израиля в глазах россиян?	Td
Каким путём пойдём?	Td
Каких берут в космонавты?	Td
Каких-то вещей, работающих во Франции, связанных с демократией и информационными технологиями?	Tu
Каков будет результат?	Td
Каков её путь к успеху?	Tu
Каков же выход?	Td
Каков масштаб утечки?	Td
Каков объём инвестиций?	Tu
Каков он, рыбный запас республики?	Tu
Каков размер страхового возмещения?	Td
Каков шоу-бизнес изнутри?	Td
Каков штраф за отсутствие детских кресел?	Td
Каков, на ваш взгляд, массовый слой потенциальных бизнес-ангелов?	Td
Какова глубина этого бассейна?	Td
Какова опасность переноса инфекций?	Td
Какова роль государства, науки, бизнеса на сегодняшний день?	Td
Какова судьба минских соглашений?	Td
Какова сумма денежного залога?	Td
Какова цена славы?	Td
Каковы её функции и перспективы?	Tu
Каковы перспективы?	Td
Каковы цели всеобщей диспансеризации?	Td
Какого вы роста?	Tu
Какого он возраста?	Td
Какого он роста?	Td
Какого размера у вас квартира?	Td
Какого это размера?	Tu
Какое было ваше общее впечатление?	Tu
Какое было домашнее задание?	Td
Какое ваше любимое блюдо?	Td
Какое отношение завод КИМ имеет к Олимпиаде-80?	Td
Какое пиво здесь разливают?	Td
Какое пиво у вас разливают?	Td
Какое сегодня число?	Tu
Какое твоё любимое блюдо?	Td
Какое тебе до этого дело?	Tu
Какой Россию видят в Поднебесной?	Tu
Какой автобус идёт в?	Td
Какой в этом смысл?	Td
Какой вид спорта самый интеллектуальный?	Tu
Какой вкус имеет это?	Td
Какой ещё гуманизм?	Tu
Какой же путь лучше, выгоднее?	Tu
Какой завтра день?	Td
Какой курс валюты?	Td
Какой максимальный вес багажа на человека?	Td
Какой номер телефона у аварийно-технической службы?	Tu
Какой он на фиг педагог?	Td
Какой оппозиции доверяет общество?	Td
Какой остаток на моём счёте?	Td
Какой пароль для доступа?	Td
Какой пол у Перми, мужской или женский?	Tu
Какой размер этого?	Td
Какой расход топлива у этого автомобиля?	Td
Какой сегодня год, вы, я полагаю, не забыли?	Tu
Какой сегодня день недели?	Td
Какой смысл жизни?	Td
Какой срок гарантии?	Td
Какой твой адрес?	Td
Какой твой любимый цвет?	Td
Какой тебе нравится больше всего?	Td
Какой телефон для вызова такси?	Td
Какой у вас номер счёта?	Td
Какой у вас размер?	Td
Какой у вас рост?	Td
Какой у неё инсульт?	Td
Какой у тебя размер обуви?	Td
Какой у тебя размер?	Tu
Какой у этого вкус?	Td
Какой факультет выбрали, какова была специализация?	Tu
Какой формат приобрёл фильм в результате?	Tu
Какой хочешь?	Tu
Какой цвет хотите?	Tu
Какой цвет хочешь?	Td
Какой это размер?	Tu
Какую группу ты любишь больше всего?	Td
Какую леску использовать для ловли лосося?	Td
Какую музыку ты слушаешь?	Td
Капитан Очевидность?	Tu
Катастрофа неизбежна?	Tu
Кем вы работаете?	Td
Кем же хотел стать в жизни юный Хрущёв?	Tu
Кем оно заполняется?	Td
Кем ты меня считаешь?	Tu
Кем ты себя считаешь?	Tu
Кем указано?	Tu
Кирилл, для вас русский неродной?	Tu
Китайский квартал кошмар или экзотика мегаполисов?	Td
Класс средний или креативный?	Tu
Клоун должен быть хорошим психологом?	Tu
Клюют?	Tu
Клюёт?	Tu
Когда ФАС позволит рассматривать жалобы через видеоконференции?	Td
Когда будем пересекать границу?	Td
Когда будет первая промежуточная посадка?	Td
Когда будет следующий паром?	Td
Когда будет у вас время?	Tu
Когда была построена эта церковь?	Tu
Когда вам удобно?	Tu
Когда возник мир?	Td
Когда вы вернётесь?	Tu
Когда вы к нам зайдёте?	Tu
Когда вы можете поступить?	Td
Когда вы можете прийти на собеседование?	Td
Когда вы отправили этот емайл?	Tu
Когда вы поняли, что хотите заниматься футболом профессионально?	Td
Когда вылетает твой самолёт?	Td
Когда ей поставили срок родов?	Td
Когда закончится кризис, рубль начнёт расти, а санкции отменят?	Tu
Когда закрываются магазины?	Td
Когда мне нужно освободить комнату?	Td
Когда могу начать?	Tu
Когда мы будем в?	Td
Когда мы вернёмся?	Tu
Когда мы перейдём границу?	Tu
Когда мы причалим к берегу?	Tu
Когда мы туда прибудем?	Tu
Когда нам придётся вернуть лыжи?	Td
Когда обеденный перерыв?	Tu
Когда окупятся вложения?	Tu
Когда он вернётся?	Tu
Когда он придёт?	Tu
Когда они придут?	Tu
Когда они приехали?	Tu
Когда они сожжены?	Td
Когда отправляется следующий поезд в Вену?	Td
Когда приходит этот поезд?	Td
Когда проверяют счётчики в квартире?	Td
Когда сделаем паузу?	Tu
Когда следующий рейс в?	Td
Когда ты её видел в последний раз?	Td
Когда ты наберёшься ума?	Tu
Когда ты наконец повзрослеешь?	Tu
Когда ты поступаешь на работу?	Tu
Когда ты туда приедешь?	Tu
Когда ты уже образумишься?	Td
Когда ты это закончишь?	Td
Когда у вас приёмные часы?	Tu
Когда узнаю результаты тестов?	Td
Когда это будет готово?	Tu
Когда это закончится?	Tu
Когда это кончится?	Td
Когда этот проект появился, кто его инициировал, кто его финансирует, кто осуществляет?	Tu
Когда я могу застать её?	Td
Когда, если не сейчас?	Td
Кого вы ищете?	Tu
Кого заберут, кого оставят?	Tu
Кого нет?	Tu
Кого ты разыгрываешь?	Tu
Кого это интересует?	Tu
Коммунизм в России провалившийся эксперимент, но что, царизм был лучше?	Tu
Коммунисты взялись за Медведева?	Tu
Кому ты это дал?	Td
Кому цветочки?	Tu
Кому, мол, нужен и интересен, этот самиздат, в век передовых информационных технологий?	Tu
Конец процветанию?	Tu
Конечно, зачем оно вам иначе, при отсутствии коммуникации?	Tu
Конфетка с обманом?	Tu
Корнет, вы женщина?	Tu
Короткий комментарий, Женя?	Tu
Коррупция, или не вступление в ЕС?	Tu
Которая трасса самая длинная?	Td
Который из них твой?	Td
Который ты возьмёшь?	Td
Который час?	Tu
Кофе или чай?	Td
Кроме того, где доказательства, что он был глухой?	Td
Крупная чехонь?	Td
Крышу пробил метеорит?	Tu
Ксения, хотелось бы у вас спросить, прошли ли уже похороны?	Tu
Кстати, а за что он погиб?	Tu
Кстати, а как вы к ним относитесь?	Td
Кстати, вам теперь понятно, почему мужчин нужно кормить мясом?	Td
Кстати, вы себя считаете начинающим?	Tu
Кстати, что за лицемерие?	Td
Кто архитектор?	Tu
Кто берёт взятки?	Td
Кто болеет гипертонией?	Td
Кто будет их владельцем?	Td
Кто будет следующим президентом?	Tu
Кто в ТСЖ председатель?	Tu
Кто в группе риска?	Td
Кто в очередь на субсидию?	Td
Кто в плюсе?	Td
Кто в списке льготников?	Tu
Кто в этом виноват?	Tu
Кто виноват?	Tu
Кто водил?	Tu
Кто возглавил штурм Зимнего?	Td
Кто вы?	Tu
Кто выигрывает?	Tu
Кто герой сегодня?	Tu
Кто говорит?	Tu
Кто даёт им кров, хлеб и зарплату?	Tu
Кто его заменит?	Tu
Кто ещё?	Tu
Кто же в ответе за всю эту неорганизованность?	Tu
Кто же ответит за происшедшее?	Td
Кто же это так испугался-то?	Td
Кто заботится об этом?	Td
Кто здесь за это отвечает?	Tu
Кто здесь заведует?	Tu
Кто знает, чем всё закончилось?	Tu
Кто знает, что нас ждёт впереди?	Td
Кто и когда их утверждал?	Td
Кто играет против кого?	Td
Кто из вас придёт?	Tu
Кто из нас может сказать, что он безгрешный?	Tu
Кто извлекает выгоду из этого?	Td
Кто им сочувствует?	Td
Кто исполняет главную роль?	Td
Кто контролирует?	Td
Кто лидирует?	Tu
Кто мне поможет?	Td
Кто мог это сделать?	Td
Кто объединил Германию?	Tu
Кто объединит?	Tu
Кто оказался сильнейшим?	Td
Кто они, эти смелые борцы за права трудящихся?	Tu
Кто они?	Td
Кто оставил свет включённым?	Tu
Кто отличился?	Tu
Кто платит налоги за несовершеннолетних?	Tu
Кто платит, откуда такие суммы и ради чего, собственно?	Tu
Кто победил в конфликте?	Tu
Кто позаботится о приобретении билетов?	Td
Кто придумал технологию?	Tu
Кто принёс эти цветы?	Td
Кто прыгнет выше всех?	Td
Кто разбил это окно?	Td
Кто режиссёр?	Tu
Кто сей щедрый спонсор земли волгоградской?	Td
Кто сильнее всех?	Td
Кто следующий в списке?	Td
Кто сочинил эту оперу?	Td
Кто стал тому причиной?	Td
Кто станет следующим президентом?	Td
Кто там будет отмерять, где чья ответственность?	Td
Кто там?	Tu
Кто тебе это дал?	Td
Кто тебе это позволил?	Tu
Кто тебе это поручил?	Tu
Кто тебе этого наговорил?	Tu
Кто тебя навёл на это?	Td
Кто тебя этому научил?	Tu
Кто теперь заказчик?	Tu
Кто ты будешь такой, рокер?	Td
Кто у вас выполняет работы по хозяйству?	Td
Кто у телефона?	Tu
Кто успел, тот и съел?	Tu
Кто хочет ответить?	Tu
Кто эта девушка?	Tu
Кто эта женщина?	Td
Кто эти люди?	Td
Кто это доплатит?	Tu
Кто это придумал?	Td
Кто это сделал?	Tu
Кто это такой?	Td
Кто, кроме упомянутых Индии и Индонезии, может сравниться с КНР?	Td
Кто, на ваш взгляд, виноват в трагедии московской школы, где ученик расстрелял учителя и полицейского?	Td
Кто-нибудь из вас это знает?	Tu
Кто-нибудь пользуется этим компьютером?	Tu
Кто-нибудь хочет добровольно?	Tu
Куда бегут в таких случаях?	Tu
Куда без него в домашнем хозяйстве, в пищевой промышленности?	Tu
Куда бы вы хотели идти?	Td
Куда вы едете в отпуск?	Tu
Куда вы идёте?	Tu
Куда вы уезжаете летом?	Td
Куда делись деньги на надбавки?	Td
Куда едет этот автобус?	Td
Куда ещё бежать за помощью?	Tu
Куда же ещё ухудшать?	Tu
Куда же ещё?	Td
Куда идти библиотекам?	Td
Куда идёт этот поезд?	Td
Куда их смещать?	Td
Куда мне сохранить этот файл?	Td
Куда можно пойти за покупками?	Tu
Куда мы пойдём завтра вечером?	Td
Куда мы собственно идём?	Td
Куда обратиться, если мне нужна натяжка ракетки?	Td
Куда обращаться за консультацией?	Td
Куда обращаться, чтобы пресечь это безобразие?	Td
Куда он исчез?	Td
Куда он шёл?	Tu
Куда он это положил?	Tu
Куда они ушли?	Tu
Куда поехать?	Tu
Куда сесть судьям?	Td
Куда смотрят архитекторы?	Td
Куда смотрят спецслужбы?	Tu
Куда спешить?	Td
Куда тебя понесло?	Tu
Куда ты дел эту книжку?	Td
Куда ты идёшь?	Tu
Куда ты положил это?	Tu
Куда ты спешишь?	Tu
Куда уехать?	Td
Куда уходите?	Tu
Куда это деть?	Td
Куда это?	Td
Купец, приказчик или милая барышня?	Tu
Купил бы он их сейчас?	Td
Легко ли быть предпринимателем?	Td
Легко ли быть русским?	Td
Лес и ружьё?	Tu
Лес растёт, а кто за ним ухаживает?	Tu
Лечащий врач?	Tu
Лечиться онлайн?	Tu
Личная неприязнь к сотруднику, начальнику?	Tu
Лишние килограммы?	Tu
Логика в чём?	Tu
Логический консерватизм?	Tu
Лучше, Бродский, объясните суду, почему вы в перерывах между работами не трудились?	Tu
Лучше, хуже или без перемен?	Tu
Лучшего желать нельзя?	Td
Любите Новую газету?	Td
Людей подразнить?	Td
Людей сокращают, а собак оставили?	Tu
Людмила, что говорят в Польше?	Td
Людям на подъезды повесили объявления?	Tu
Максим, вы пешком по городу ходите?	Tu
Максим, где Вы там нашли посадки?	Td
Максим, откуда столько отрицательного?	Td
Мама всё выдержит?	Tu
Марсиане, что ли?	Tu
Мах, вы всё это к чему?	Tu
Маша, а Вы русский язык в школе изучали?	Tu
Между Россией и Украиной?	Tu
Между кем и кем вводить миротворческий контингент?	Tu
Между официальной властью и террористами?	Tu
Меня спрашивают, как люди это терпят?	Tu
Меня что, арестовали?	Tu
Милосердие к людям?	Tu
Миф или реальное существо?	Td
Миша и Света, так Вас зовут?	Td
Мне выключить телевизор?	Td
Мне надо делать пересадку?	Td
Мне надо сделать пересадку?	Td
Мне нужен рецепт?	Tu
Мне нужна рабочая виза?	Td
Мне сесть за руль?	Tu
Мне туда сходить?	Tu
Мне тут какое дело?	Td
Мне это взять с собой?	Tu
Мне, значит, уже пора идти?	Tu
Много ли в Туле безработных, и возможно ли их пересчитать?	Td
Много ли из них подтверждается?	Td
Много ли подготовки, профессионализма у тех, кто нынче?	Tu
Могли бы вы мне помочь?	Td
Могли бы вы нам дать ключ?	Td
Могу взять неоплачиваемый отпуск?	Tu
Могу здесь оставить туалетные принадлежности?	Td
Могу использовать это полотенце?	Tu
Могу ли я использовать авиабилет на следующий рейс?	Td
Могу одолжить ваш насос?	Td
Могу опробовать вспышку?	Td
Могу открыть окно?	Td
Могу открыть окошко?	Tu
Могу позвонить с вашего телефона?	Tu
Могу получить ещё один?	Td
Могу попросить отрегулировать крепления?	Td
Могу попросить принести нам ужин в номер?	Td
Могу попросить страховки при жиме лёжа?	Td
Могу посмотреть эти духи?	Td
Могу принять душ?	Tu
Могу скачать что-нибудь на флешку?	Tu
Могу создать ярлык на рабочем столе?	Tu
Могу убавить отопление?	Tu
Могу я вас покинуть на минутку?	Td
Могу я взять этот маркер?	Td
Могу я здесь оставить свой багаж?	Td
Могу я кое-что предложить?	Td
Могу я оставить себе это?	Td
Могу я подняться на борт самолёта?	Tu
Могу я пойти с вами?	Td
Могу я получить жилье, хотя бы временное?	Tu
Могу я получить рыболовный билет?	Td
Могу я получить?	Tu
Могу я пригласить тебя на рюмочку?	Td
Могу я с вами говорить?	Tu
Могу я это посмотреть?	Tu
Могут ли выселить за долги?	Td
Мода против женщин?	Tu
Модернизация, говорите?	Tu
Можем ли мы здесь поставить палатку?	Td
Можем мы добраться туда на машине?	Td
Может быть, вас надо подвезти?	Tu
Может быть, всё дело в том, что учение было лишь средством, инструментом?	Tu
Может быть, до декабрьских выборов?	Tu
Может быть, его узнают родственники?	Tu
Может быть, и книгу тому предложить, кто речь писал?	Tu
Может быть, имело смысл расширить список видов для мониторинга?	Td
Может быть, лучше быть и красивым, и здоровым?	Tu
Может быть, она действительно обрела бессмертие, вечную молодость?	Td
Может быть, теоретик безумия?	Tu
Может быть, уже закончился их срок эксплуатации?	Tu
Может быть, художественные?	Tu
Может быть, чище стали наши подъезды?	Tu
Может быть, это заболевание?	Tu
Может быть, это обсудим?	Tu
Может ли русский язык сегодня являться международным?	Td
Может лучше подождать?	Tu
Может меня кто-нибудь встретить в аэропорту?	Td
Может, Зубков пойдёт?	Td
Может, брачный договор?	Tu
Может, в городе и ошиблись врачи, может, ей ещё жить и жить?	Tu
Может, в роддоме вас подменили?	Tu
Может, взять на весну?	Tu
Может, всё ещё образуется?	Tu
Может, вы поможете?	Tu
Может, генотип такой?	Tu
Может, главу подкупает?	Tu
Может, и единственная?	Tu
Может, и мы попробуем?	Tu
Может, и правда пора сделать паузу, хотя бы в кризисной ситуации?	Tu
Может, им подсказать?	Tu
Может, лучше двойки?	Td
Может, лучше собаку?	Tu
Может, мы и произошли от самих себя?	Td
Может, мы и хлеб будем гнать из Евросоюза?	Tu
Может, не такой уж был и снайпер?	Tu
Может, о том, что в России полным ходом идёт милитаризация?	Tu
Может, он в коридоре?	Tu
Может, он и впрямь, как говорил Жириновский, сын Андропова?	Tu
Может, опечатка?	Tu
Может, опять сработал стереотип?	Tu
Может, отдал последнее?	Tu
Может, отправлять в ГИБДД записи?	Tu
Может, перетерпеть возможную девальвацию?	Td
Может, перечитать?	Tu
Может, повторим?	Tu
Может, подсократить круг её прав и обязанностей?	Tu
Может, пора уже рассредоточиться, расслабиться?	Tu
Может, пословица иностранная?	Tu
Может, правда, лучше назначить в стране другую валюту и вздохнуть с облегчением?	Tu
Может, с хлеба?	Tu
Может, снять их с довольствия?	Tu
Может, совпадение?	Tu
Может, спросим?	Tu
Может, стоит ехать всё же медленнее?	Tu
Может, таким и поделом?	Tu
Может, туда бомбу бросить?	Tu
Может, у белорусов анатомия и физиология другая?	Td
Может, уже раньше все-таки получили, но куда оно перешло в другие руки?	Td
Может, форум переименовать?	Tu
Может, хозяин найдётся?	Tu
Может, через пять лет, но закроют непременно, и что тогда?	Tu
Может, это время отвечает времени, а не фильм фильму?	Tu
Можете ли вы мне показать моё место?	Tu
Можете ли вы прийти в другой раз?	Td
Можете ли вы это проверить?	Td
Можете меня переключить?	Td
Можете меня предупредить, когда туда приедем?	Td
Можете мне дать более мелкие банкноты?	Td
Можете мне настроить тормоза?	Td
Можете мне отремонтировать проколотую шину?	Td
Можете мне сделать центровку переднего колеса?	Td
Можете открыть багажник?	Td
Можете поделиться впечатлениями?	Td
Можете прислать это по электронной почте?	Td
Можешь себе это вообще представить?	Td
Можешь это за меня заплатить?	Td
Можно в озере купаться?	Tu
Можно вас кое о чём спросить?	Tu
Можно вас на пару слов?	Td
Можно вас прервать на минутку?	Td
Можно вернуть машину в другом офисе вашей компании?	Td
Можно взять ваш номер телефона?	Tu
Можно взять напрокат и детские лыжи?	Td
Можно взять напрокат надувной матрац?	Td
Можно взять твою машину?	Tu
Можно взять у вас напрокат снаряжение для дайвинга?	Td
Можно войти?	Tu
Можно вылезть на самой верх?	Tu
Можно где-нибудь здесь взять на прокат другую машину?	Td
Можно говорить погромче?	Td
Можно заглянуть в городской музей?	Td
Можно загорать топлес?	Td
Можно заниматься на беговой дорожке?	Td
Можно здесь взять напрокат велосипеды?	Td
Можно здесь где-нибудь недалеко поесть?	Td
Можно здесь купить энергетический напиток?	Td
Можно здесь курить?	Td
Можно здесь немножко задержаться и осмотреться?	Td
Можно здесь пойти куда-нибудь повеселиться?	Tu
Можно здесь развести костёр?	Tu
Можно информировать моих родственников?	Tu
Можно к вам обратиться с просьбой?	Td
Можно купить билет прямо в поезде?	Tu
Можно ли вас попросить?	Tu
Можно ли где-нибудь поблизости поиграть в теннис?	Td
Можно ли ему верить?	Td
Можно ли здесь оставить машину?	Tu
Можно ли мне платить наличными?	Td
Можно ли это купить в Интернете?	Tu
Можно ли это перенести на понедельник?	Td
Можно ли это устроить?	Td
Можно мне взять?	Td
Можно мне ещё кофе?	Tu
Можно мне играть с вами?	Td
Можно мне поехать с вами?	Td
Можно мне пойти?	Td
Можно мне снять пальто?	Td
Можно мне снять пиджак?	Td
Можно мне это завернуть?	Td
Можно на него положиться?	Td
Можно на пляже собирать ракушки?	Td
Можно одолжить вашу ручку?	Td
Можно оставить вещи в палатке?	Td
Можно оставить ему сообщение?	Td
Можно оставить свои вещи в машине?	Td
Можно остановиться всего на одну ночь?	Tu
Можно платить кредитной картой?	Td
Можно поговорить с вашим начальником?	Td
Можно подняться на верхнюю палубу?	Td
Можно подняться на эту башню?	Td
Можно получить пакет?	Td
Можно пользоваться тоже кухней?	Tu
Можно попросить без льда?	Tu
Можно попросить лишнее одеяло?	Td
Можно примерить?	Td
Можно просмотреть это?	Td
Можно сесть вперёд?	Td
Можно сесть на терассе?	Td
Можно сюда въехать с жилым прицепом?	Td
Можно туда добраться на машине?	Td
Можно у вас забронировать номер на двое суток?	Td
Можно ходить через заднюю дверь?	Td
Можно, я тебя поцелую?	Td
Можно-ли нам сесть сюда?	Td
Мой идеал счастья?	Tu
Мол, вы хотите обогнать нас экономически?	Tu
Молодец, а чем ещё?	Tu
Мочить в квартире?	Tu
Мощность двигателя?	Tu
Мутации жителей Москвы неизбежны?	Tu
Мы ведь говорим о литературе, а не о шоу-бизнесе?	Tu
Мы возьмём такси?	Tu
Мы все знаем об автомобилях, а каков мир мотоциклов?	Tu
Мы выделили время для семьи и друзей?	Td
Мы даём славянофильство и западничество?	Tu
Мы ещё не переходим к дискуссии?	Tu
Мы ещё увидимся?	Tu
Мы же за объективность информации?	Tu
Мы зря бежали?	Tu
Мы могли бы посмотреть какие-нибудь достопримечательности?	Td
Мы можем на тебя рассчитывать?	Td
Мы можем немножко отдохнуть?	Td
Мы можем сойти с маркированного туристического пути?	Td
Мы не ошиблись?	Tu
Мы обязаны перед отъездом убрать комнату?	Td
Мы пропустили кого-нибудь?	Td
Мы только не поняли, чья рождаемость?	Td
Мы успеем?	Tu
Мы что, Нидерланды?	Tu
Мысль интересная, но как её воплотить?	Td
На 15 лет вперёд?	Tu
На глубине?	Tu
На гнев и милость?	Tu
На какой остановке мне выходить?	Td
На каком месяце беременности она?	Td
На каком этаже вы живёте?	Tu
На какую глубину можно погружаться?	Td
На китайский язык, к примеру?	Tu
На кого покинул нас, отец родной?	Td
На котором месяце беременности?	Td
На могиле?	Tu
На реку за смертью?	Tu
На сколько кадров хватает аккумулятора?	Td
На сколько лет он старше?	Td
На сколько он выше?	Td
На сколько снастей разрешается ловить?	Td
На том, что даём людям высказаться?	Tu
На третью?	Tu
На улице тепло?	Tu
На уровне абстракции?	Tu
На что надеялся?	Td
На что поспорим?	Tu
На что рассчитываете?	Tu
На что ты смотришь?	Tu
На чём сэкономить?	Td
На чём это ездит?	Td
На экран компьютера?	Tu
На этот раз повезло, до следующего?	Tu
Наверное, очень дорого?	Tu
Наверное, счастлив?	Tu
Наверное, тоже одобряют?	Tu
Наверное, я ему понравился?	Tu
Надежда на спортплощадки?	Tu
Надежду убил бюджет?	Tu
Надеть костюм из мяса?	Tu
Надеюсь, оно сохранилось?	Tu
Найдут ли убийц Бориса Немцова?	Td
Нам что делить, ярлыки и оскорбления?	Tu
Напитки включены в стоимость?	Tu
Например, как курить на остановке?	Tu
Насколько надёжно, на ваш взгляд, защищены объекты Общества от пожаров?	Td
Насколько?	Tu
Настя, каким образом не допустят?	Td
Насчёт подписей я Вам ответил, да?	Tu
Начался кашель?	Tu
Наш поезд придёт точно по расписанию?	Tu
Наш пёс не турист?	Tu
Нашего брата, пенсионера, разве любят в больницах и поликлиниках?	Tu
Не ассоциируется ли у них течение реки со временем, которое, к счастью, проходит?	Td
Не благотворно, понимаешь?	Tu
Не боишься, что посадят?	Td
Не было ли конфликтов?	Tu
Не в обиду будет сказано, но почему ты это делаешь?	Td
Не жалость и сожаление, а поддержка?	Tu
Не заметила?	Tu
Не затруднит?	Tu
Не могли бы вы меня подтолкнуть?	Tu
Не могли бы вы минуточку подождать?	Td
Не могли бы вы мне посоветовать?	Tu
Не могли бы вы одолжить мне ручку?	Td
Не могли бы мы поменяться местами?	Td
Не находите?	Tu
Не нашлась вакансия?	Tu
Не нравится, когда показывают?	Tu
Не от грязи ли?	Td
Не отменили?	Tu
Не отсюда ли корни?	Td
Не ошибся ли академик?	Td
Не поможете мне понести багаж наверх?	Td
Не понимаю, зачем ломать?	Tu
Не понятно, чему они сейчас обучаются, чему их учат в автошколах?	Td
Не правда ли, необыкновенно вдохновляет?	Tu
Не правда ли?	Td
Не пытаешься ты подцепить меня?	Td
Не рассказывал?	Tu
Не снаружи, а внутри?	Tu
Не способны к самоорганизации?	Tu
Не справилась?	Tu
Не спрятаться, не скрыться?	Tu
Не так ли, господа и товарищи?	Td
Не убедительно?	Tu
Не узнаёшь дорогу, по которой мы едем?	Td
Не фонтан?	Tu
Не хило, да?	Tu
Не хотите ли выпить что-нибудь?	Td
Не хотите сыграть парную встречу?	Tu
Не хочется, конечно, стариться, но куды деваться?	Tu
Не хочешь прийти на ужин?	Td
Не чужой же?	Td
Не шутя?	Tu
Не, не слышал?	Tu
Негатив один?	Td
Нельзя ли схемы клеить почаще?	Td
Нельзя технологиями?	Tu
Нельзя убивать людей?	Tu
Немного клише, тебе не кажется?	Td
Несчастная любовь?	Tu
Нет ли здесь заинтересованности?	Td
Нет радиосвязи?	Tu
Нет той атмосферы тепла, понимаешь?	Tu
Неужели зритель жаждет лишь фантастики?	Tu
Неужели она ему это сказала?	Td
Неужели придётся радоваться, что хоть она, слава богу, есть?	Td
Неужели так можно?	Td
Неужели теперь мы, жильцы, будем защищены от произвола коммунальщиков?	Td
Неужели только мы, в своей вере, в истине, а все остальные во лжи?	Td
Неужели учителем?	Td
Неужели я должна прийти?	Td
Нефть дешевеет?	Tu
Нечего взять, кроме анализов?	Tu
Нечем гордиться, да?	Tu
Ни базы, ни Крыма, ни Донецка, ни Харькова?	Tu
Никита Павлович, а кто адресат этой бумаги, этой нашей концепции?	Td
Ничего необычного, правда?	Tu
Но вдруг да не этих коррупционеров, а прошлых оранжевых?	Tu
Но ведь убил же?	Td
Но видят ли этот сборник в регионах?	Td
Но вы где находитесь?	Td
Но где взять финансы?	Td
Но где же доказательства?	Td
Но где, в каких вузах готовят таких специалистов?	Tu
Но две думы разве объявили голодовку?	Tu
Но ещё купим, да?	Tu
Но зачем, как в советское время, обременять предприятия?	Tu
Но как же её выкинуть?	Td
Но как помочь, как достучаться до этих родных друг другу сердец?	Td
Но как проверить, все ли их выполняют?	Tu
Но как, а главное где их обслуживать?	Td
Но каков результат?	Td
Но каковы итоги года минувшего?	Td
Но один тоннель открываем, когда второй будем?	Tu
Но по какой причине утерян, украден, испорчен?	Tu
Но почему сын носил шляпу?	Td
Но почему, собственно, я начал именно с мормышки?	Td
Но разве Иисус Христос бог страха, а не любви?	Tu
Но разве в деньгах счастье?	Td
Но разве этот хаос, дестабилизация, запах большой войны случайны?	Tu
Но стоит ли жалеть об этом, его читателям?	Td
Но у неё маленький ребёнок, зачем пугать его на ночь глядя?	Td
Но что могут учёные, кроме физических формул и химических реакций?	Tu
Но что случилось с людьми, которые в своё время кричали о переменах, о несправедливости?	Tu
Но что, если сделать её виртуальной?	Td
Но что-то мы всё о женщинах, а где же мужчины?	Td
Но это уже так, к слову, а что дальше?	Tu
Но, уже наконец, что именно входит в состав этих ценностей?	Tu
Номер машины, какому государству принадлежит?	Td
Ну а в целом, по вашему мнению, успеют?	Tu
Ну а тем, у кого станция не в шаговой доступности?	Tu
Ну вынесли антиквариат, ну денег или ещё чего, убивать-то зачем?	Tu
Ну где ещё расслабиться, если не на берегу?	Tu
Ну и где был Севастополь?	Tu
Ну и как у тебя вышло?	Td
Ну и кто победит?	Tu
Ну и с кем они будут сотрудничать?	Tu
Ну и удачи, как же без неё в лесу?	Tu
Ну и чем тогда французы лучше?	Td
Ну и что, не общаться?	Tu
Ну и что, что женатый?	Tu
Ну и что?	Tu
Ну как?	Tu
Ну люди, куда же мы все торопимся?	Td
Ну не ребус?	Tu
Ну объявит Украина Россию войну, а дальше что?	Tu
Ну так что?	Tu
Ну хорошо, а зачем тогда нужна была эта либерализация?	Td
Ну что за несправедливость?	Tu
Ну что на тебя опять нашло?	Td
Ну что уставился?	Tu
Ну что, продолжим вечер?	Td
Ну, а в чём состоит альтернатива?	Tu
Ну, а кто у нас ещё либерал?	Tu
Ну, в самом деле, зачем прессе портить себе и своим любимым зелёным праздник?	Td
Ну, зачем мы будем за этим гоняться?	Td
Ну, как люди всю жизнь курили, неужели они бросят сейчас?	Tu
Ну, как оберегают?	Tu
Ну, как понять, что знают американцы, куда идти?	Td
Ну, не бред ли?	Td
Ну, пришли бы на площадь Революции, и что?	Tu
Ну, разве не привлекательно?	Tu
Ну, согласитесь, откуда нам знать, что у иностранцев на уме?	Td
Ну, что на это сказать?	Tu
Ну, что нет аргументов за Воробьёва?	Tu
Ну, что скажете?	Tu
Ну, что теперь предпримем?	Tu
Ну, чтобы всё было объективно?	Tu
Ну, я в тренде?	Tu
Нужен диагноз?	Tu
Нужен ли подвиг?	Td
Нужна печать журналов?	Tu
Нужна экспертиза?	Tu
Нужно ли России лесоустройство?	Tu
Нужно ли освидетельствование?	Tu
Нужны ли все эти услуги обществу?	Td
Нулевая, положительная?	Tu
О здоровье курильщиков позаботились?	Tu
О какой сумме идёт речь?	Td
О музыке?	Tu
О нет, что он задумал?	Tu
О чем бы мы, живя в Гонконге, сейчас беседу вели?	Tu
О чем ещё мечтают туляки?	Tu
О чём вы разговаривали?	Td
О чём же они говорили?	Tu
О чём задумались, медведи?	Tu
О чём мечтают россияне?	Td
О чём ты говоришь?	Tu
О чём ты думаешь?	Td
О чём это свидетельствует?	Tu
О чём это?	Td
О, рыцарь со столь ярким даром, Где ты учился мастерству?	Tu
ОАЭ не диктатура?	Tu
Обама с Меркель?	Tu
Обмениваете чешские кроны?	Td
Объясните, почему?	Tu
Обычные ссылки на инертность?	Tu
Одного не понял, когда Воробьёв выходил на сцену, зачем рекламу по ТВ включали?	Tu
Озеро и травка?	Tu
Окончил вуз и стал безработным?	Tu
Октябрьской революции?	Tu
Он будет гулять, жить?	Tu
Он был депутатом?	Tu
Он говорит правду?	Tu
Он до 100 лет выходил на сцену в спектаклях, представляете?	Tu
Он дома?	Tu
Он ещё в живых?	Tu
Он же сел ещё в день выборов?	Tu
Он женился на ней?	Td
Он живой?	Tu
Он и победил, но вот с каким результатом?	Tu
Он мне это дал. Правда?	Tu
Он может и плохой человек, но представьте, что бабки сюда не дошли?	Td
Он подтвердил это письменно?	Tu
Он пришёл?	Tu
Он тебе что-нибудь сделал?	Tu
Он тоже спорил?	Td
Он умеет читать?	Td
Он холостой или женатый?	Td
Он что, совсем глупый?	Tu
Он это принёс?	Tu
Она актуальна для девелоперов?	Td
Она вообще сказала что-нибудь?	Td
Она поступила в вуз?	Td
Она с ним переспала?	Tu
Она уже переспала с ним?	Td
Она умная?	Tu
Они будут исполнены?	Tu
Они ведь мужскую сборную представляют?	Td
Они вид на жительство дают, представляешь?	Tu
Они друг к другу подходят?	Tu
Они могут взять инвалида, а мы не можем?	Tu
Они надолго приехали?	Td
Они об этом не знали, что ли?	Td
Они ремонтируют?	Tu
Они уже пришли?	Tu
Опасен ли выбор самых дешёвых фильтров?	Td
Опасно ли брать деньги взаймы?	Td
Оплата производится при заезде или при выезде?	Tu
Оппозиционерка или вице-губернатор?	Tu
Опять воспитатели?	Td
Опять же где пистолет?	Tu
Опять же, а сила тяготения?	Tu
Опять лес, что с лесом, ночью упал лист с сосны, слышали?	Tu
Оркестра и цветов?	Tu
Орёл или решка?	Td
Осень жизни?	Tu
Особенно чужое?	Tu
Оставим, как есть?	Tu
Останавливается поезд в?	Tu
Остаётся ли время для инноваций?	Td
От кого независимости?	Tu
От кого ты получил это?	Td
От кого ты получил эту информацию?	Tu
От кого ты узнал это?	Td
От тех ли, кто пришёл позже?	Tu
От чего защищаться?	Tu
От чего он умер?	Td
От чего она умерла?	Td
Ответил он тебе на этот вопрос?	Td
Ответственный владелец?	Tu
Ответят на вопрос, понял бы Пушкин язык интернета?	Tu
Отклик сердца на цвет, на запах, на линию моря?	Tu
Откуда вообще взялась сумма в 15 миллионов рублей?	Td
Откуда вы родом?	Tu
Откуда ж им взять любовь к Родине?	Tu
Откуда же взялись эти странные цифры?	Td
Откуда мне знать?	Tu
Откуда мы знаем друг друга?	Tu
Откуда он приехал?	Tu
Откуда отправляется автобус в?	Td
Откуда сквозит?	Td
Откуда ты взял это?	Td
Откуда ты звонишь?	Tu
Откуда ты здесь взялся?	Td
Откуда ты?	Td
Откуда у России миллион гектаров леса для китайцев?	Tu
Откуда это?	Td
Откуда, чёрт возьми, мне знать, что он там скажет?	Tu
Отсутствие пандусов законно?	Tu
Отсутствие совести?	Tu
Отсутствием дверей в подъездах?	Tu
Отчаянный шаг или легкомыслие?	Tu
Офигеть, вы это видели?	Tu
Охрану не выставили?	Tu
Очень убедительно, да?	Tu
Очковый недуг принял?	Td
Ощутил запах гниения?	Td
Ощущаем мы этот процесс?	Td
Пакет или упаковка?	Td
Парниковый эффект миф?	Tu
Пациент жив или мёртв?	Td
Пациент скорее жив, чем мёртв?	Tu
Паша, ты мне поможешь?	Tu
Певец ли он?	Tu
Первой свежести?	Tu
Перед экзаменом иногда, да?	Tu
Пересменка, что ли?	Td
Перечень нужен для сравнения?	Tu
Пиар на Подмосковье?	Tu
Пиво будешь?	Tu
Писатель русский?	Tu
Писать слитно или раздельно?	Td
Пишите, как у вас дела?	Td
Плохие учителя?	Tu
Плохо едим?	Tu
Плюнуть и забыть, что и делает большинство?	Td
По какой причине вы это сделали?	Td
По какой причине?	Tu
По какой цене?	Tu
По какому поводу?	Tu
По обмену?	Tu
По принципу, с кем пока проще договориться, или всё же для какой-то целевой аудитории?	Tu
Победить на конкурсах?	Tu
Погружаться будем с лодки?	Tu
Подвиг по наследству?	Tu
Поддержите инициативу?	Td
Подиум или саморазвитие?	Tu
Подождите, в чём суть вопроса?	Td
Подскажите, а?	Tu
Подскажите, где достать карту города?	Td
Подскажите, как?	Tu
Подскажите, пожалуйста, входит ли в стаж служба в армии?	Td
Подтопить?	Td
Подумаешь, насилуют?	Tu
Подходит это для меня?	Tu
Пожар в номере?	Tu
Пойдём ко мне домой?	Tu
Пойдём на концерт?	Td
Пойдём на пляж?	Tu
Пойдём пива попьём, хочешь?	Tu
Пойдём, погуляем немножко?	Td
Получается, всех всё устраивает?	Tu
Получается, мы, автовладельцы, перед страховщиками абсолютно беззащитны?	Tu
Получается, у некоторых школ есть преференции, им не нужно укрупняться?	Tu
Получилось?	Tu
Поменьше коррупции, побольше зарплату?	Tu
Поменяемся?	Tu
Помилуй, кто тебе это сказал?	Td
Помните поджог Рейхстага?	Td
Помните эти строчки, Геннадий Игоревич?	Td
Помните, как весь город друг другу рассказывал?	Tu
Помните, как всё начиналось?	Tu
Помнишь, как всё начиналось?	Td
Поможешь мне намазать спину кремом для загара?	Td
Понимаете, да?	Tu
Понимаете, о чем идёт речь?	Tu
Понимаешь, о чём я говорю?	Tu
Понимал ли он их вполне?	Tu
Понял ли сегодня Интернет уровень критики у тех, кто им активно пользуется, по ощущениям?	Tu
Понятно, что их надо различать, но по каким критериям?	Tu
Попробуем подняться наверх, на холм?	Td
Пора сдавать валюту в обменник?	Tu
Посадить всех этих людей в тюрьму опять?	Tu
Посадка деревьев?	Tu
После майских?	Tu
Посмотрите, разрешат ли?	Td
Посоветуйте, что делать?	Td
Поспорим?	Tu
Потому как мог ещё долго болеть, но числится?	Td
Похож ли фильм на секс между зрителем и режиссёром?	Td
Похоже, ей проще снять деньги с жильцов, чем готовить пакет документов для получения денег из бюджета?	Td
Почему Африка, почему сейчас?	Tu
Почему Грузия?	Td
Почему Европа?	Tu
Почему Кембридж был для меня предпочтительнее?	Td
Почему Сенегал?	Tu
Почему абстрактная?	Tu
Почему ангелы?	Td
Почему аутсайдер?	Tu
Почему борода синяя?	Td
Почему бы не изучить их, например, в интернете, и не попробовать реализовать?	Td
Почему в Татарстане, Нижнем Новгороде, Вологде, Владимире получается?	Td
Почему в неглиже, спросите вы?	Td
Почему в областную, надо сразу было в генеральную?	Tu
Почему вдруг профессия экономиста, финансиста?	Td
Почему виртуально?	Td
Почему владимирский образец пятиглавый?	Td
Почему внештатный?	Tu
Почему все эти, связанные друг с другом мошенники, до сих пор у власти?	Tu
Почему вы в своё время занялись футболом?	Td
Почему вы не признали мою рекламацию?	Td
Почему домра?	Td
Почему же не вычеркнули?	Td
Почему же он мне не сказал это откровенно?	Td
Почему заинтересован?	Tu
Почему залпом?	Td
Почему именно с этим учреждением?	Td
Почему исследователей?	Tu
Почему криминальной?	Tu
Почему людей вводят в заблуждение?	Tu
Почему мастерская?	Tu
Почему миллиардер платит меньше налогов, чем его секретарь?	Tu
Почему молчит телевидение?	Td
Почему не был вызван дежурный врач-хирург?	Tu
Почему не интересен?	Td
Почему не испугались?	Td
Почему не течёт тёплая вода?	Tu
Почему нельзя жечь мусор?	Td
Почему неудачной?	Td
Почему огурец и почему зелёный?	Tu
Почему он нам врёт?	Td
Почему он плохиш?	Td
Почему он создал промышленность?	Td
Почему она деревянная?	Td
Почему она ошиблась?	Td
Почему она, внучка своей бабушки, не бросилась на помощь, когда той она потребовалась?	Td
Почему они нам не доверяют?	Tu
Почему они образовались, эти проблемы?	Tu
Почему они тебя не пригласили?	Td
Почему опять Волгоград?	Td
Почему ошибочно?	Td
Почему периферия?	Tu
Почему петух машет крыльями?	Td
Почему преждевременный?	Tu
Почему сейчас решили информировать?	Td
Почему смешно?	Tu
Почему троцкист?	Td
Почему ты делаешь такое лицо?	Td
Почему ты не попробуешь это чаще?	Tu
Почему ты плачешь?	Td
Почему ты прямо не спросишь у него?	Td
Почему ты так думаешь?	Td
Почему удобно?	Td
Почему уходят мужья?	Tu
Почему фестиваль рыжий?	Td
Почему хомячок?	Tu
Почему эрекция, эякуляция и оргазм могут быть тремя независимыми событиями?	Tu
Почему это странно?	Td
Почему я выздоровел?	Tu
Почему я должен это делать?	Td
Почему я, русский человек, депутат от Новосибирской области, должен уезжать?	Tu
Почему, как вы думаете?	Td
Почему, на ваш взгляд, так много банков закрывается?	Tu
Почему, спрашивается?	Td
Почём джип для слуги народа?	Td
Почём колбаса для пенсионера?	Td
Почём это?	Tu
Почём?	Tu
Поэт или писатель?	Tu
Поэтому, что сейчас прогнозировать?	Tu
Прав ли Центробанк?	Tu
Прав ли продавец?	Td
Правда?	Tu
Правильный вопрос у вас Александр, а кто же следующий чемпион?	Td
Предоставляете гарантию возврата денег?	Td
Предпочла бы я свою жизнь жизни в семье?	Tu
Представляете, какой мощный удар по атмосфере?	Tu
Представляете, кчему это приведёт?	Tu
Представляете, сколько их нужно подготовить?	Tu
Представляешь, какое бы это было?	Td
Президент воспринимается, скорее, как институт, а не как личность?	Tu
Презрение к противнику, снобизм?	Tu
При чем тут глобализация?	Tu
При чём здесь фальшивомонетчики?	Td
Привить значит обезопасить?	Tu
Придётся мне платить сейчас или при отъезде?	Td
Придёшь?	Tu
Признаться, я в это слабо верю, а вы?	Tu
Принимаешь снотворное?	Td
Принципиально тяжелее?	Tu
Пришло время отыгрываться?	Tu
Проверку законности?	Tu
Продукты мы можем ставить в холодильник?	Td
Прописку отменили?	Tu
Пропустил я что-нибудь?	Td
Простите, где туалеты?	Td
Простите, как?	Tu
Простить и забыть все эти смерти, увечья, разрушения?	Tu
Профессиональный фотограф?	Tu
Прохожий, ну почему же?	Td
Прошу прощения, какую электричку?	Tu
Прощай навсегда?	Tu
Прощай, оружие?	Tu
Психолога нет в группе?	Td
Пулемёт к бою готов?	Tu
Пули всегда летят в лучших?	Tu
Пусть вытесняет?	Tu
Пусть платят втридорога за горючее?	Td
Пчелы против мёда?	Tu
Пчёл выгонят из деревень?	Tu
Пьеса была плоха?	Tu
Пьяный ехал?	Td
Ради будущего?	Tu
Ради демократии?	Tu
Ради количества?	Tu
Ради нефти?	Tu
Радио слушаете?	Tu
Радость, ликование?	Tu
Разве ЭТО справедливо?	Tu
Разве в деньгах?	Tu
Разве крест аргумент?	Tu
Разве они без нас не справятся?	Td
Разве плохи лозунги?	Tu
Разве такими вещами шутят?	Tu
Разве ты не видишь?	Tu
Разве уже пять?	Tu
Разве это в человеческих силах?	Td
Разве это вообще возможно?	Tu
Разве я бы мог ей такое сделать?	Td
Разговор зашёл о психологии, о чём ещё болтать в смешанной компании перед горячим?	Tu
Разжевать по пунктам?	Tu
Размер взноса?	Tu
Разницу чувствуете?	Tu
Разрешается выезд на автомобиле в другие страны?	Tu
Разрешите мне позвонить с вашего телефона?	Td
Разрешите пригласить вас на танец?	Td
Разрослась собственная коллекция?	Td
Распространяется гарантия также на?	Tu
Расскажите нам, чему верить?	Td
Расскажите, каковы они?	Td
Расскажите, пожалуйста, что это такое, откуда она появилась?	Td
Расскажите, что произошло?	Tu
Расстрел или спецоперация?	Tu
Реально ли выучить язык на ощупь?	Tu
Ребята, какой итог?	Td
Ребятишки слушались?	Tu
Ребёнка подарила миру, Чтоб затем, лишив его тепла, Укатить транзитным пассажиром?	Tu
Революцию, к которой она привела?	Tu
Рейд закончен?	Tu
Рекламный пакет, в конце концов?	Tu
Религия, церковь?	Tu
Реформа где в законах?	Tu
Речь идёт обо мне?	Tu
Родину не любишь, да?	Tu
Родственник в больницу попал?	Tu
Розетка участвует?	Tu
Романтический позитивизм?	Tu
Россия воюет против ЛНР?	Tu
Россия начнёт импортировать бензин?	Tu
Руководителей партий, массмедиа?	Tu
Русские фильмы для новых русских?	Tu
Русский менталитет?	Tu
Русский язык сегодня Какой он, русский язык, сегодня?	Td
Русской литературе, народу?	Tu
С другой стороны, зачем власти образованный, интеллигентный народ?	Tu
С другой стороны, нужны ли неудачники работодателям?	Td
С другой стороны, разве могут быть границы у хороших инициатив?	Td
С их долгами всему миру?	Td
С каких пор депутаты ГД интересуются тем, что пишут в соцсетях?	Tu
С каких пор ты изменяешь ей?	Td
С какого возраста?	Tu
С какого времени?	Tu
С какой руки?	Tu
С какой скоростью мы едем?	Td
С кем воюем-то?	Td
С кем договариваться?	Tu
С кем он будет взаимодействовать?	Td
С кем она там была?	Td
С кем хотите говорить?	Tu
С кем я говорю?	Tu
С которого часа ты работаешь?	Td
С которого часа?	Tu
С пониманием?	Tu
С согласия, понимаете?	Tu
С тобой всё в порядке?	Td
С чего начнём?	Tu
С чем ассоциируется Голландия?	Tu
С чем едят?	Tu
С чем мы хотим себя ассоциировать?	Tu
С чем связан кризис малых партий?	Td
С чем сейчас работать, как запретить вырубку?	Td
С чем тут спорить?	Td
С чем я был не согласен?	Tu
Садики дали, а пойдём когда?	Tu
Сам ездит на автомобиле, и всех приучить хочет?	Td
Сами идут, по желанию, или опускают того, кто понравится?	Tu
Самый многочисленный?	Tu
Саша Мельников, например?	Tu
Свадьба по доверенности?	Tu
Сверхурочная работа оплачивается?	Tu
Свечку, купленную в храме?	Tu
Свистун, где аргументы?	Tu
Свобода лучше, чем несвобода?	Tu
Свой среди чужих?	Tu
Сделать мне это?	Td
Сделать сенсацию?	Tu
Сделка десятилетия?	Tu
Сегодня Абхазия, а завтра Грузия?	Tu
Сейчас Вы осознаёте?	Tu
Сейчас он уже сложился?	Tu
Сейчас эта наука прогрессирует?	Tu
Семь, говорите?	Tu
Сергей Волков, например?	Tu
Сергей, бог с тобой; где здесь силы, где предел и где страсть?	Tu
Серьёзно?	Tu
Сестра парикмахера Сергея?	Tu
Сжечь Стамбул можно, но зачем?	Tu
Сигнал сверху был какой-то?	Tu
Символ одиночества?	Tu
Символично, не находите?	Tu
Скажете, детская сказочка?	Tu
Скажете, мелочи?	Tu
Скажете, нет?	Tu
Скажете, сказка?	Tu
Скажете, что совпадение?	Tu
Скажи, как тебе этот фильм понравился?	Td
Скажи, что мы теряем?	Td
Скажите пожалуйста, когда поезд прибывает в?	Td
Скажите, России это надо?	Tu
Скажите, а бомжи у нас голосуют?	Tu
Скажите, в чём суть взносов на капремонт?	Tu
Скажите, где мой багаж теперь находится?	Td
Скажите, пожалуйста, зачем вы пришли сюда, где сидят одни интеллигенты?	Tu
Скажите, совпало?	Tu
Скажите, чем, на ваш взгляд, педиатр отличается от других врачей?	Tu
Скажите, это Вы письменность изобрели, а заодно и сразу интернет?	Tu
Скидка касается и этого?	Tu
Сколько берёте за страницу?	Tu
Сколько в России средних классов?	Td
Сколько вас?	Td
Сколько взимается за возврат авиабилета?	Td
Сколько времени длится обзорная экскурсия?	Td
Сколько времени длится плавание?	Td
Сколько времени длится поход?	Td
Сколько времени занимает дорога до аэропорта?	Td
Сколько времени здесь стоит поезд?	Tu
Сколько времени мы будем в пути?	Td
Сколько времени надо, чтобы добраться до города?	Td
Сколько времени это у тебя отнимет?	Td
Сколько времени?	Tu
Сколько выполнишь подтягиваний на перекладине?	Td
Сколько градусов на высоте 1000 метров?	Td
Сколько денег у тебя осталось?	Td
Сколько длятся остановки?	Td
Сколько дней отпуска мне положено?	Td
Сколько ему лет?	Td
Сколько здесь стоит пиво?	Tu
Сколько километров пробега включено в стоимость аренды?	Td
Сколько кусков?	Tu
Сколько либералов среди интеллигенции и представителей искусства, культуры, науки?	Td
Сколько людей придёт?	Td
Сколько мне ещё придётся ждать?	Tu
Сколько мне нужно платить за перевес?	Td
Сколько мы на этом заработаем?	Td
Сколько они насчитали за это?	Td
Сколько остановок отсюда?	Tu
Сколько перечислять?	Tu
Сколько получаешь в месяц?	Td
Сколько раз в день мне это принимать?	Tu
Сколько раз в день ходят паромы в?	Td
Сколько раз в неделю вы встречаетесь?	Td
Сколько раз вы видели друг друга?	Td
Сколько раз я должен это повторять?	Tu
Сколько с меня?	Td
Сколько стоит аренда на один день?	Td
Сколько стоит билет в одном направлении?	Td
Сколько стоит билет?	Tu
Сколько стоит взрослый билет?	Td
Сколько стоит входной билет?	Td
Сколько стоит километр?	Td
Сколько стоит новая батарея?	Tu
Сколько стоит номер в сутки?	Td
Сколько стоит ночлег для двух человек в сутки?	Td
Сколько стоит обратьный билет в?	Td
Сколько стоит письмо в?	Td
Сколько стоит прокат гидроцикла?	Td
Сколько стоит рыболовная лицензия на неделю?	Tu
Сколько стоит такая экскурсия?	Td
Сколько стоит электричество в день?	Td
Сколько стоит эта карта?	Td
Сколько стоят билеты в театр?	Td
Сколько стоят билеты?	Td
Сколько там вместится?	Td
Сколько твоя машина жрёт бензина?	Td
Сколько тебе лет?	Tu
Сколько ты зарабатываешь в год?	Td
Сколько ты на это потратил?	Td
Сколько ты потратил?	Td
Сколько у нас времени?	Tu
Сколько у них детей?	Tu
Сколько это будет стоить?	Tu
Сколько это в день?	Td
Сколько это в итоге стоит?	Td
Сколько это весит?	Tu
Сколько это может стоить?	Tu
Сколько это остановок отсюда?	Tu
Сколько это стоит за ночь?	Td
Сколько это стоит на ночь?	Td
Сколько это стоит?	Td
Сколько это уже лет?	Tu
Сколько я вам должен?	Tu
Сколько языков ты знаешь?	Td
Слепой, что ли?	Td
Слили революцию?	Td
Слов много, эмоций много, а что осталось в остатке?	Td
Сломался троллейбус?	Tu
Случилось что-нибудь?	Td
Случись беда?	Tu
Слушай, и это кто такой?	Tu
Слушаю?	Tu
Слышишь ли меня?	Td
Слышишь?	Tu
Слышь, а ты всегда по Библии живёшь?	Tu
Смех или слёзы?	Tu
Сможет ли экипаж общаться с родными?	Tu
Смотрел я на тебя, может, думаю, мозгляк какой?	Tu
Снеговик упал, спросите вы?	Td
Снизилась ли смертность?	Tu
Собственно, как эта легитимность подтверждается?	Td
Собчак покинула Россию с подачи спецслужб?	Tu
Совсем чуть-чуть?	Tu
Согласен?	Tu
Согласитесь, не поспоришь?	Tu
Содержать пожизненно?	Tu
Соломки подстелить?	Td
Соскочить с эксперимента?	Tu
Сплетня в виде версии?	Tu
Способ извлечения ресурсов для жизни из земли, скота и растений?	Tu
Спрашивается, для чего?	Tu
Спрашивается, зачем?	Tu
Спрашивается, почему?	Tu
Спрашиваю, в чём причина?	Td
Спросил, где я была раньше?	Tu
Спросите, за что погиб?	Tu
Сразу и на Север?	Tu
Сродни, или то же самое?	Td
Ссылку на проект можно?	Tu
Ставка больше, чем жизнь?	Tu
Стала ли для москвичей трагедия неожиданностью?	Tu
Стали ли меньше брать взяток в ГИБДД?	Td
Стали разбираться, что к чему?	Tu
Сталин к войне?	Tu
Стоит ли?	Td
Стой. Кто там?	Tu
Столько?	Tu
Стоп, где это я?	Td
Суверенной демократии?	Tu
Суды не судят?	Tu
Судят по делам вроде как?	Td
Судят справедливо?	Tu
Существует ли жизнь на других планетах?	Td
Существует ли колдовство?	Tu
Считаете, что маловато?	Tu
Сыграем в бильярд?	Tu
Сырьевые собственники?	Tu
Сядет ли?	Td
Та, которая, на ваш взгляд, удалась лучше других?	Tu
Так вы не про зверюшек?	Tu
Так где же аргументы?	Td
Так где же коррекция?	Td
Так где же справедливость?	Td
Так действительно, чей он?	Tu
Так зачем же чинить людям такие препятствия?	Tu
Так как же уберечься от телефонных мошенничеств?	Td
Так каковы же перспективы?	Td
Так какой же мотив покупать DVD у нас ещё остаётся?	Td
Так много?	Tu
Так поздно?	Tu
Так почему так всё безнаказанно?	Td
Так чего беспокоиться?	Tu
Так что с ней тогда, с частной собственностью?	Tu
Так что, будем ждать кровавых жертв?	Tu
Так что, отложим на другой раз?	Tu
Так что, товарищ Медведев?	Tu
Так, может, дружба и нужна для того, чтоб не бояться?	Tu
Так, может, стоит копнуть глубже и поискать трещину в самом фундаменте?	Tu
Так, на чём я остановился?	Td
Таких вариантов в сети хватает, но зачем?	Td
Такой путь вы используете?	Tu
Такси здесь стоит дорого?	Tu
Талоны отменены?	Tu
Там достаточно снега для катания?	Tu
Там есть спальный вагон?	Td
Там есть что-нибудь о письмах президенту?	Td
Там не дорого?	Tu
Твой папа дома?	Tu
Те же эфемериды ГЛОНАСС чем не открытые данные?	Tu
Тебе близок детерминизм?	Td
Тебе есть где жить?	Td
Тебе есть у кого спросить?	Tu
Тебе не хотелось бы прийти?	Td
Тебе нечем заняться?	Tu
Тебе нравится это пиво?	Td
Тебе повезло?	Tu
Тебе уже теплее?	Tu
Тебе это ничего не говорит?	Td
Тебе это ничего не напоминает?	Tu
Тебе это нравится?	Tu
Тебя, старческий маразм посетил?	Td
Телевизор смотрите?	Tu
Тем, что поступали в вузы по связям?	Tu
Теодицея, да?	Tu
Теоретически он мог сбежать, но куда?	Tu
Теперь их опять хотят выгнать на площади?	Td
Теперь можно бордюры снимать, асфальт сдирать?	Tu
Теперь тысячи российских пьяниц обречены насмерть замёрзнуть в сугробах?	Tu
Теперь, получается, с вашим уходом представительство России в МОК уменьшится?	Tu
Типа, а чё пришли?	Tu
Типа, ну чё пришёл?	Tu
То есть ваш рейтинг про элиту журналистики?	Tu
То есть, во сне?	Tu
То есть, мы до сих пор не знаем, где здесь причина, а где следствие?	Tu
То есть, ум как природный ресурс?	Tu
То, что ещё вчера считалось коррупцией, сегодня легче легализовать, чем искоренить?	Tu
Товарищи генералы?	Tu
Тогда, почему живы?	Tu
Тоже коллектив выбрал?	Tu
Тоже расстрелять?	Td
Только куда, на сериал?	Tu
Только рабочих и бюджетников?	Tu
Только спросил, будет ли там электроника?	Tu
Только тем, что москвичи?	Tu
Торг здесь уместен?	Tu
Точно?	Tu
Трагедия, понимаете?	Tu
Требуется лицензия на ловлю рыбы?	Tu
Трудиться по специальности?	Tu
Туда можно доехать на автомобиле?	Tu
Тут напрашивается вопрос: Был это несчастный случай?	Td
Ты боишься?	Tu
Ты будешь составлять мне компанию?	Td
Ты бы в это поверил?	Tu
Ты в каком классе?	Td
Ты в порядке?	Tu
Ты веришь в Бога?	Td
Ты веришь в них?	Tu
Ты взял гектар?	Tu
Ты видел вчера этот матч?	Td
Ты видела, какой символ выбрали?	Td
Ты вполне здоров?	Td
Ты вправду так думаешь?	Td
Ты встречаешься с кем-нибудь?	Td
Ты всё проверил?	Td
Ты выйдешь за меня замуж?	Td
Ты выйдешь замуж за меня?	Td
Ты выпускаешь рыбу обратно в воду?	Td
Ты говоришь по-английски?	Tu
Ты голоден?	Tu
Ты готов?	Tu
Ты дашь мне свой номер телефона?	Td
Ты думаешь, ты меня ударил?	Tu
Ты его ещё любишь?	Tu
Ты его уже видишь?	Tu
Ты ездишь на работу на машине?	Tu
Ты ещё не готов?	Tu
Ты ещё съел бумажку какую-то?	Tu
Ты её гулять приглашал?	Tu
Ты же не думаешь, что я тебе это дам?	Td
Ты закрыл окно?	Td
Ты занимаешься какими-нибудь видами спорта?	Td
Ты запер дверь?	Td
Ты записался добровольцем?	Td
Ты здесь долго не останешься, правда?	Tu
Ты знаешь это, или только гадаешь?	Td
Ты знаешь, как привести это в действие?	Tu
Ты знаешь, кто такой поросёнок?	Td
Ты когда-нибудь играл в дартс?	Tu
Ты куда-нибудь собираешься?	Tu
Ты купил билеты?	Td
Ты лишился рассудка?	Tu
Ты меня водишь за нос?	Td
Ты меня заменишь?	Tu
Ты меня разыгрываешь?	Tu
Ты меня слушаешь?	Tu
Ты меня туда подвезёшь?	Tu
Ты мечтала быть художником?	Tu
Ты мне голову морочишь?	Td
Ты можешь двинуть рукой?	Tu
Ты можешь за меня замолвить словечко?	Td
Ты можешь запустить эту программу?	Td
Ты можешь мне подсказать?	Tu
Ты можешь приглушить звук?	Td
Ты можешь себе представить, какое бы это было?	Td
Ты можешь себе это представить?	Td
Ты можешь что-нибудь для меня устроить?	Tu
Ты на каком месяце?	Td
Ты не мог бы мне это показать?	Td
Ты не можешь ещё подвинуться?	Td
Ты не предубеждён против него?	Td
Ты не сможешь меня понять?	Tu
Ты не хочешь зайти завтра ко мне?	Td
Ты не хочешь зайти ко мне на минуточку?	Td
Ты не хочешь кусок пирога?	Td
Ты не хочешь поменяться местами?	Td
Ты не хочешь сок?	Td
Ты о них слышал?	Tu
Ты об этом разве ещё не слышал?	Tu
Ты обещаешь?	Tu
Ты онемел?	Tu
Ты останешься на ночь?	Td
Ты открыл бы окно?	Td
Ты откуда здесь взялся?	Td
Ты переспал с ней?	Td
Ты подготовлен?	Tu
Ты поедешь с нами?	Td
Ты поймал что-нибудь?	Td
Ты поможешь мне это сделать?	Td
Ты помыл машину?	Td
Ты понял эту шутку?	Td
Ты понял?	Tu
Ты почистил зубы?	Td
Ты приведёшь нас туда?	Td
Ты приезжаешь сюда часто?	Tu
Ты приехал в отпуск или по делам?	Td
Ты принёс бы мне стакан?	Td
Ты присоединишься к нам?	Td
Ты проглотил язык?	Tu
Ты простишь мне это?	Td
Ты разбираешься в двигателях?	Td
Ты разбираешься в современном искусстве?	Td
Ты рюкзак привезла?	Tu
Ты с кем говоришь?	Tu
Ты с луны свалился?	Td
Ты с ним хорошо ладишь?	Td
Ты с ума сошёл?	Td
Ты с этим справишься один?	Td
Ты сдал этот экзамен?	Td
Ты сделаешь 30 отжиманий от пола?	Td
Ты сделаешь что-нибудь для меня?	Tu
Ты сделаешь это для меня?	Td
Ты смотрел последний эпизод?	Tu
Ты согласен?	Tu
Ты сообщил об этом?	Td
Ты спишь?	Tu
Ты спросил его об этом?	Td
Ты сумеешь починить это?	Td
Ты сумеешь это сделать?	Td
Ты считаешь его своим другом?	Tu
Ты там уже был когда-нибудь?	Td
Ты тоже хочешь прийти?	Td
Ты туда не ходил, правда?	Tu
Ты уверен?	Tu
Ты уже всё купил?	Tu
Ты уже выполнил домашние задания?	Td
Ты уже закончил?	Tu
Ты уже какое пиво по счёту пьёшь?	Td
Ты уже когда-нибудь летел самолётом?	Tu
Ты уже на ногах?	Tu
Ты уже не спишь?	Tu
Ты уже об этом читал?	Tu
Ты уже отдохнул?	Tu
Ты уже принял решение?	Td
Ты уже проснулся?	Tu
Ты уже решился на что-нибудь?	Tu
Ты уже это попробовал?	Tu
Ты узнаешь его?	Td
Ты умеешь ездить верхом?	Td
Ты умеешь завязать галстук?	Td
Ты умеешь молчать?	Td
Ты умеешь печатать всеми десятью пальцами?	Td
Ты умеешь сделать стойку?	Td
Ты умеешь тасовать карты?	Tu
Ты умеешь это?	Td
Ты успел оформить дачу?	Td
Ты хорошо выспался?	Td
Ты хорошо проводишь время?	Td
Ты хорошо развлекаешься?	Td
Ты хочешь меня расстроить?	Tu
Ты хочешь подраться?	Tu
Ты хочешь этот поменьше или побольше?	Td
Ты чего?	Tu
Ты читал этот роман?	Td
Ты что блядь, шутишь?	Tu
Ты что выдумал?	Tu
Ты что, не знала?	Tu
Ты что, с луны упал?	Td
Ты что, с ума сошёл?	Td
Ты что, сумерничаешь?	Tu
Ты чуешь это?	Td
Ты шутишь надо мной?	Td
Ты шутишь?	Tu
Ты шутки не понимаешь?	Td
Ты это имеешь в виду?	Td
Ты это купил, правда?	Tu
Ты это понимаешь, ну что, сложно бросить ссылку в соответствующий орган?	Tu
Ты это понимаешь?	Tu
Ты это серьёзно думаешь?	Td
Ты это тоже видишь?	Td
Ты это уже доделал?	Tu
Ты это уже когда-нибудь пробовал?	Tu
Ты это уже смотрел?	Tu
Ты язык проглотил?	Td
Ты, кого имеешь в виду?	Td
Тёмный, ты навек для меня светлый, ясный сокол?	Td
У вас болит что-нибудь?	Td
У вас вертикаль?	Tu
У вас есть большая семья?	Tu
У вас есть гиппопотам?	Td
У вас есть дети?	Td
У вас есть доступ в Интернет?	Td
У вас есть ещё вопросы?	Td
У вас есть какая-нибудь идея?	Tu
У вас есть какие-нибудь таблетки от укачивания?	Td
У вас есть какой-нибудь другой?	Tu
У вас есть какой-нибудь сыр?	Td
У вас есть минута?	Td
У вас есть рабочая виза?	Td
У вас есть разливное пиво?	Td
У вас есть разрешение на проживание?	Td
У вас есть родственники за границей?	Td
У вас есть свободные номера?	Tu
У вас есть свободный номер?	Td
У вас есть свободный стол?	Tu
У вас есть скидки?	Td
У вас есть часы?	Td
У вас есть что-нибудь к этому добавить?	Td
У вас можно взять также прицеп?	Tu
У вас можно зайти в тренажёрный зал?	Td
У вас можно обменять деньги?	Td
У вас можно поесть?	Td
У вас не найдётся что-нибудь подешевле?	Td
У вас плата за человека или за палатку?	Tu
У единороссов кадровый резерв есть, только непонятно, чем эти люди отличились?	Td
У которого окошка приём пакетов?	Td
У меня всё хорошо. А вы как?	Tu
У меня шок почему?	Tu
У нас уже были счётчики, но почему их сняли?	Td
У неё что, совесть заговорила?	Tu
У тебя есть билеты?	Tu
У тебя есть брат или сестра?	Tu
У тебя есть какая-нибудь идея?	Td
У тебя есть кто-нибудь?	Td
У тебя есть минутка?	Tu
У тебя есть немного времени?	Td
У тебя есть презерватив?	Td
У тебя есть свободное время сегодня вечером?	Td
У тебя есть старые выпуски?	Td
У тебя есть это?	Td
У этого отеля имеется свой пляж?	Td
Убивать лучших людей?	Tu
Убрали стажа годы учёбы в вузе, годы ухода за детьми?	Tu
Увидеть Париж и умереть?	Tu
Удалось?	Tu
Удастся ли вернуть эти миллиарды?	Tu
Удивила чем-нибудь?	Tu
Уже всё понятно?	Tu
Уже начался сезон ловли форели?	Td
Узнавать, как у них там с медицинской помощью?	Tu
Узнаем, хорошо ли он работает?	Td
Улавливаешь?	Tu
Улов я могу забрать домой?	Tu
Улучшилось самочувствие?	Tu
Умер протест?	Td
Умно, а?	Tu
Упал, как при теракте?	Tu
Условия договора, я так понимаю, как всегда, собранием не утверждены?	Tu
Услуги экскурсовода включены в стоимость экскурсии?	Td
Установить видеонаблюдение?	Tu
Уходя на пенсию, я начала размышлять, как жить дальше?	Td
Ухудшилось ли питание?	Tu
Учитель математики?	Tu
Учитывая цены на столичную жилплощадь, может, один запасной?	Tu
Факт, достойный Книги рекордов Гиннесса?	Tu
Федеральное законодательство?	Tu
Физкультура, конечно, полезна для здоровья, но стоит ли оно того?	Tu
Физкультура, спорт и здоровье или алкоголь, табак и связанные с ними недуги?	Tu
Французская разведка?	Tu
Фронтовик он или не фронтовик?	Tu
Футуризм или психоделия?	Td
Хватит ли у нас ресурсов для того, чтобы решить проблемы, если они возникнут?	Td
Хлеб без масла?	Tu
Холодно в квартире?	Tu
Холодно, правда?	Tu
Хорошо бы посоветоваться, но с кем?	Tu
Хорошо, не бесплатно, но хотя бы в аренду или путём приобретения в собственность?	Tu
Хотелось бы оптимизма, но как?	Tu
Хотелось бы уточнить, кем должны быть эти люди, из какой организации?	Tu
Хотите доказательств?	Tu
Хотите присоединиться?	Tu
Хотите разводиться?	Tu
Хотите расскажу, как мужьям изменять?	Td
Хотите увидеть свою будущую улыбку?	Td
Хотите чаю?	Td
Хотите чего-нибудь выпить?	Td
Хотите, покажу?	Td
Хотите, чтобы я ему позвонил?	Tu
Хоть юрлицо, хоть какое?	Tu
Хотя для Вас, возможно, ОБСЕ это не авторитет?	Tu
Хотя какая конкуренция?	Td
Хотя какие это болельщики?	Td
Хотя, может быть, из Украины виднее то, что в Марий Эл происходит?	Tu
Хотят в чем-то убедиться?	Tu
Хотят увековечить память Немцова?	Tu
Хочется чего-нибудь покушать?	Tu
Хочешь газету?	Tu
Хочешь денег?	Td
Хочешь ещё пример?	Td
Хочешь записаться?	Td
Хочешь покататься на лошади?	Td
Хочешь проехаться верхом на лошади?	Td
Хочешь спуститься по водной горке?	Td
Хочешь уничтожить особь?	Tu
Хочешь, чтоб вас тут вообще не трогали?	Td
Хочешь, я тебя отвезу в город?	Td
Художественную литературу?	Tu
Хуже некуда?	Tu
Цены будут корректировать?	Tu
Церковь, как институт или Вера?	Tu
Чай?	Tu
Чего боитесь?	Td
Чего вам?	Td
Чего добились?	Tu
Чего же ты хочешь?	Tu
Чего изволите?	Tu
Чего их пересчитывать?	Tu
Чего мы лишились?	Td
Чего нам секретничать?	Td
Чего он от меня хочет?	Tu
Чего тут непонятного?	Td
Чего ты боишься?	Tu
Чего ты добиваешься?	Td
Чего ты добьёшься таким путём?	Td
Чего ты желаешь?	Td
Чего ты хочешь?	Tu
Чего ты этим добиваешься?	Tu
Чего уж лукавить?	Tu
Чей это ребёнок?	Td
Чей-то труп?	Tu
Человек собаке друг?	Tu
Чем больны?	Tu
Чем вы занимаетесь?	Td
Чем вы теперь недовольны?	Td
Чем вы увлекаетесь?	Tu
Чем год запомнится, чем сердце успокоится?	Tu
Чем гордится Новомосковск?	Tu
Чем горжусь?	Tu
Чем дело кончилось?	Td
Чем же их загрузить?	Tu
Чем же плоха зубрёжка?	Td
Чем же тебя занять, малыш?	Tu
Чем же хорош данный сайт?	Td
Чем же хороша коза?	Td
Чем занимаешься?	Tu
Чем именно хорош мир без купюр?	Tu
Чем интересовался?	Tu
Чем их удержать?	Tu
Чем людям отапливаться, если газа нет?	Tu
Чем не мистерия и не мифотворчество?	Td
Чем не наушничество?	Tu
Чем не угодила площадь Европы, мы что, не европейцы?	Tu
Чем он привлекателен?	Td
Чем она интересна?	Td
Чем опасен ВИЧ?	Td
Чем опасен горький шоколад?	Td
Чем отличается колледж от техникума?	Td
Чем полезен лох?	Tu
Чем сердце успокоится?	Tu
Чем счастлива женщина?	Td
Чем ты занимаешься?	Tu
Чем ты любишь заниматься?	Td
Чем хороша игра?	Td
Чем черт не шутит?	Td
Чем это объясняется?	Tu
Чем я, Юрий Белоусов, живущий сегодня в Воскресенске, могу помочь людям?	Tu
Чему и как учить детей и молодёжь?	Td
Чему научит зомби?	Tu
Чему радоваться?	Td
Чему тут удивляться?	Td
Чему ты смеёшься?	Tu
Чему удивляешься?	Tu
Чему учит война?	Tu
Чему учит ислам?	Td
Чему учить учителей?	Td
Чему хоть удивляться?	Tu
Чему я радуюсь?	Tu
Через какое время может быть багаж доставлен?	Td
Чересчур сложная формулировка, трудно сразу понять, о чём речь?	Tu
Чечня, например?	Tu
Что берёт русский язык у своих соседей?	Tu
Что будет с глобализацией?	Td
Что будет следовать?	Tu
Что будете пить?	Tu
Что бы вы мне порекомендовали?	Tu
Что бы вы мне посоветовали?	Tu
Что бы случилось, если бы я ему это сказал?	Td
Что в Таиланде?	Tu
Что в корзине в магазине?	Tu
Что в этом плохого?	Td
Что важнее в футболе, а что в бизнесе?	Td
Что вам здесь нужно?	Td
Что вам могу предложить?	Tu
Что вам можно предложить?	Tu
Что вам нужно?	Tu
Что вам угодно?	Td
Что вас связывает, что?	Tu
Что вас сюда привело?	Td
Что взамен?	Tu
Что включается в страховку?	Td
Что входит в экскурсию?	Tu
Что вы будете пить?	Td
Что вы видите на этой картинке?	Td
Что вы имеете в виду?	Td
Что вы мне советуете?	Tu
Что вы нам посоветуете?	Tu
Что вы об этом думаете?	Td
Что вы от меня хотите?	Tu
Что вы тут делали?	Tu
Что вы хотите сделать с этим?	Td
Что вы хотите сказать?	Tu
Что вы этим хотите сказать?	Td
Что гласит закон?	Td
Что говорил?	Td
Что даёт ему эволюционировать?	Tu
Что делать, если в магазине откажутся принять обувь на экспертизу?	Td
Что делают дружинники?	Td
Что для них характерно?	Td
Что для тебя духовность?	Td
Что едят кошки?	Td
Что ещё делать семьям, где супруги живут на 4,5 тысячи в месяц?	Tu
Что ещё известно про географию?	Tu
Что ещё могу для вас сделать?	Tu
Что ещё хочешь?	Td
Что ждёт Землю?	Tu
Что ждёт неплательщиков?	Tu
Что ждёт пенсионеров в связи с кризисом?	Tu
Что ждёт туляков в августе?	Td
Что же ещё, кроме дозы, делает яд лекарством, а лекарство ядом?	Td
Что же нам теперь делать?	Tu
Что же нужно сделать, чтобы жанр рассказа был востребован журналами, газетами, читателем?	Tu
Что же он тебе ответил на это?	Td
Что же тебя бесит?	Tu
Что же тебя заставило изменить своё мнение?	Td
Что же ты сделал?	Tu
Что же ты смеёшься?	Tu
Что же я буду делать?	Tu
Что же, топить?	Tu
Что за демпинг такой?	Td
Что за оказия, создатель?	Tu
Что за человек был Николай Михайлович?	Td
Что за чушь вы пишете?	Td
Что заставило его изменить имя?	Td
Что здесь воняет?	Tu
Что здесь происходит?	Td
Что значит быть коренным?	Td
Что значит далёк от коммерсантов?	Tu
Что значит заговор, в чём заговор?	Td
Что идёт?	Tu
Что из этого вытекает?	Tu
Что издаёт эти звуки?	Td
Что изменили?	Tu
Что иного, будет в газете?	Td
Что конкретно ты имеешь в виду?	Td
Что лучше, аренда или покупка техники?	Td
Что любит хрен?	Td
Что мне за это будет?	Td
Что мне остаётся?	Td
Что мне понадобится?	Td
Что мне с этим делать?	Td
Что может быть интереснее, чем путешествия?	Tu
Что может предложить ОЭЗ китайским предпринимателям?	Tu
Что мы приобрели?	Td
Что мы, взрывов не видели?	Tu
Что нам взять с собой?	Tu
Что нового?	Tu
Что нынче в Средней Азии пьют?	Td
Что общего у тех, кто живёт долго и счастливо?	Td
Что он дурачится?	Td
Что он за человек?	Td
Что он сказал?	Td
Что он там в действительности делал?	Td
Что она надела?	Td
Что они решают, эти концепции?	Tu
Что они там делают?	Td
Что они украли?	Tu
Что ответил ведущий?	Tu
Что отмечал стритрейсер?	Tu
Что отсюда следует?	Tu
Что перспективно, что интересно?	Tu
Что поделаешь?	Td
Что пожелаете?	Tu
Что показывают в кино?	Tu
Что показывают вечером по телевизору?	Td
Что поют в цирке?	Td
Что предпочитает?	Tu
Что предпочитаете пить?	Td
Что предпочитаете?	Tu
Что привело к отставке?	Td
Что произойдёт, если растения вдруг исчезнут с земли?	Td
Что происходит?	Td
Что реформировать?	Tu
Что с ним творится?	Tu
Что с ним?	Td
Что с резервами?	Tu
Что с тобой случилось?	Tu
Что с этим будем делать?	Td
Что сделать, если у меня возникнут проблемы?	Td
Что сейчас книжка?	Td
Что скажешь?	Tu
Что случилось?	Tu
Что сообщить в заключение?	Td
Что спровоцировало пузырь на рынке недвижимости?	Tu
Что стоит обязательно посмотреть?	Td
Что такое переизбыток?	Td
Что такое?	Td
Что там ещё Крючков перечислял?	Td
Что там способно растлить ум и душу 15-летнего?	Tu
Что тебе больше надо?	Td
Что тебе в этом мешает?	Td
Что тебе в этом нравится?	Tu
Что тебе мешает?	Td
Что тебя волнует?	Td
Что тебя гложет?	Td
Что тебя задержало?	Td
Что тебя к этому привело?	Td
Что тебя привлекло, кроме денег?	Td
Что тебя раздражает?	Td
Что теперь сделать?	Td
Что теперь, бросать работу?	Tu
Что ты будешь делать завтра?	Td
Что ты будешь кушать?	Td
Что ты готовишь?	Tu
Что ты делаешь завтра вечером?	Td
Что ты делаешь сегодня вечером?	Td
Что ты делаешь?	Td
Что ты думаешь?	Tu
Что ты замышляешь?	Td
Что ты здесь делаешь?	Td
Что ты изучаешь?	Tu
Что ты к ней чувствуешь?	Td
Что ты любишь больше всего?	Td
Что ты любишь делать?	Td
Что ты на это скажешь?	Tu
Что ты наделал?	Td
Что ты наденешь?	Td
Что ты намерен сделать?	Td
Что ты натворил?	Td
Что ты об этом думаешь?	Td
Что ты от меня хочешь?	Td
Что ты плетёшь?	Td
Что ты предполагаешь делать?	Tu
Что ты пытаешься сделать?	Td
Что ты пьёшь?	Td
Что ты с ума сошёл?	Td
Что ты сказал?	Td
Что ты смеёшься?	Td
Что ты смотришь?	Tu
Что ты этим хотел доказать?	Tu
Что ты этим хочешь сказать?	Tu
Что у вас в холодильнике?	Tu
Что у нас поесть?	Tu
Что уж ждать педагогам?	Tu
Что умеют первоклашки?	Td
Что хорошего, мы считаем, мы делаем для проектов?	Td
Что чаще всего в них ищут?	Td
Что это даёт?	Td
Что это за вопрос?	Td
Что это за материал?	Td
Что это за мужик?	Td
Что это такое?	Td
Что это тебе взбрело в голову?	Tu
Что это феномен эпохи?	Tu
Что это, как не коррупция?	Tu
Что я разбойник?	Tu
Что я сделал плохо?	Td
Что я слышу в своём кругу и в русском?	Td
Что я тебе сделал?	Td
Что является эффективным веществом этого лекарства?	Td
Что является эффективным?	Td
Что, Андрей Николаевич занят?	Tu
Что, все цены изменились?	Tu
Что, если в РФ плохо, то Крым не нужен?	Tu
Что, и в Белоруссии тренеры лучше российских?	Tu
Что, и у Гитлера нельзя красть?	Tu
Что, мы сами себя поджигать будем?	Td
Что, не по нраву?	Tu
Что, нельзя наладить обмен сведениями между всеми тремя организациями?	Tu
Что, особенно на первых порах, должно быть обязательно?	Tu
Что, про воздух я уже говорила?	Tu
Что, съели?	Tu
Что, толку не будет?	Tu
Что, уже пилить начинают?	Tu
Что, уже столько времени?	Tu
Что-нибудь особенно запомнилось?	Tu
Что-то не так?	Tu
Чтоб вконец добить?	Td
Чтоб все его заметили, поняли, как он им дорог, защитили его?	Tu
Чтобы уж не отлынивать?	Tu
Чувствуешь разницу?	Td
Чьих будешь?	Tu
Чья жизнь дороже?	Tu
Чья земля?	Tu
Чья идея?	Td
Чья книга лучше?	Tu
Чья это вина?	Tu
Чьё решение будут исполнять?	Td
Чьё это?	Td
Чё теперь делать-то?	Td
Чё, статью написал?	Td
Шить умеете?	Tu
Шлем обязателен?	Tu
Штраф в рассрочку возможен?	Tu
Шумиха вокруг Евгения Плющенко?	Tu
Экзамен будете устраивать?	Tu
Экстенсивный или интенсивный?	Td
Электронную почту?	Tu
Эта собака кусается?	Tu
Эти часы идут точно?	Tu
Это Антонов, что ли, ушёл на больничный так вовремя?	Td
Это Гребенников самый порядочный?	Td
Это автомобиль с кондиционером?	Tu
Это болит?	Tu
Это будет больно?	Tu
Это будет большая свадьба?	Tu
Это будет сложно?	Tu
Это был он. Действительно?	Tu
Это было необходимо?	Tu
Это было у вас дома?	Tu
Это важно?	Tu
Это вы о чём, простите?	Td
Это генетика, воспитание, влияние школы, общества в целом?	Tu
Это грунтовый корт или с бетонным покрытием?	Td
Это далеко отсюда?	Tu
Это действительно действует?	Td
Это для меня?	Tu
Это для нас?	Tu
Это дорога в?	Td
Это его машина?	Td
Это ж вам не убийц ловить, правда?	Tu
Это займёт много времени?	Td
Это заразно?	Tu
Это как вам, скажите, пожалуйста, как специалист?	Td
Это какого цвета?	Td
Это консерватизм, возврат к традициям?	Tu
Это место свободно?	Tu
Это можно взять с собой на борт?	Td
Это не слишком сильно?	Td
Это не слишком тяжело для тебя?	Td
Это не средневековье?	Tu
Это обслуживание номеров, пожалуйста?	Td
Это он?	Tu
Это оснащено оптическим зумом?	Tu
Это пицца по телефону?	Tu
Это по твоему вкусу?	Td
Это поезд в?	Td
Это почему же так?	Td
Это прямой рейс?	Td
Это серьёзно?	Tu
Это симптом дефицита, но дефицита чего?	Tu
Это совпадает?	Tu
Это срочно?	Tu
Это твоя жена?	Tu
Это тебе что-то напоминает?	Tu
Это трудно проходимая местность?	Td
Это ты?	Tu
Это уже работает?	Tu
Это что, экстремистский сайт?	Tu
Это, конечно, хорошо, но как изучать головной мозг в голове у человека?	Tu
Это, что за феномен такой?	Td
Этот автобус идёт в?	Tu
Этот брендинг утверждён?	Tu
Этот поход могут выбрать также пожилые люди?	Td
Этот рейс будет с промежуточной посадкой?	Tu
Эффективен ли мониторинг?	Tu
Я вам не помешал?	Tu
Я вас разбудил?	Tu
Я высказался вполне определённо?	Td
Я должен за это заплатить пошлину?	Tu
Я должен заполнить все поля?	Tu
Я должен иметь велошлем?	Td
Я должен комментировать?	Tu
Я могу вам помочь?	Td
Я могу вас пригласить на танец?	Tu
Я могу здесь взять на один день лодку напрокат?	Td
Я могу один взять?	Td
Я могу примерить эти брюки?	Td
Я не знаю, в шесть лет можно говорить, есть у ребёнка слух, голос или рано ещё?	Tu
Я не мешаю?	Tu
Я не ошибаюсь?	Tu
Я понимаю, технологии развиваются, но можно ли успокоить москвичей?	Tu
Я пропустил что-нибудь?	Td
Я решил поискать, в других регионах что?	Tu
Я с кем говорю?	Td
Я согласен, но вот смотрите?	Tu
Я спросил, что им говорил врач, когда родился их ребёнок?	Td
Я так поняла, там форма собственности всё же не ЗАО, а ОАО?	Tu
Я тебе когда-нибудь врал?	Tu
Я тут причём?	Tu
Я что-нибудь пропустил?	Tu
Явка будет?	Tu
а в чём их травма?	Tu
а вы везучий человек?	Td
а где же наша промышленность?	Tu
а где же прорывы, где штурм Кремля?	Tu
а где компас?	Tu
а если форс-мажор?	Tu
а зачем, когда жизнь интереснее?	Tu
а каковы были взаимоотношения у вас в семье, с супругом, кто главный?	Td
а может, ещё что последует?	Tu
а поедут ли к нам теперь вообще?	Td
а почему в церковь не ходят русские мужчины?	Td
а почему вы считаете, что газ для своих недоступен?	Td
а почему почтальон?	Tu
а то ли сейчас время, чтобы гайки закручивать?	Tu
а чего, собственно, извиняться, если решила жизнь поменять?	Tu
а что, они до сих пор не объединены?	Tu
амбиции или необходимость?	Tu
ах, да, и вы заметили насколько многих людей НЕТ в фильме?	Td
барин или наниматель?	Td
боль за страну, ответственность за её будущее?	Td
в деньгах ли счастье?	Tu
в чём его энтелехия?	Td
в чём подвох?	Td
в чём фишка?	Td
ваше сердце свободно?	Tu
вдруг целый триллион наберётся?	Td
велика разница?	Td
верхом на лошади?	Tu
включить кондиционер, освещение витрины или холодильник?	Tu
вот это оплеуха, что теперь будет?	Tu
вражда из-за чего?	Tu
все больны?	Tu
всех физически на руки не взять, а как выбрать одного?	Td
вы в своём уме вообще?	Td
вы дебил?	Tu
вы же хлеб в магазине покупаете?	Tu
вы живы, с вами всё в порядке?	Td
где были, почему молчали?	Tu
где движется рассказ и где рассказчик?	Tu
где же видео репортажи?	Tu
где купить фильм легально?	Td
где подписи собирают?	Tu
где руководство этих фирм, где работники, где деньги?	Tu
где школьнику искать информацию?	Tu
героизм это или самоубийство?	Td
гражданин, а Вы какую нацию имеете ввиду?	Td
да зачем мне медик, механик?	Tu
деньги виноваты?	Td
дескать, зачем они?	Tu
для чего сейчас, в третий раз, даётся очередная отсрочка?	Td
до меня сдавали, а я чем хуже?	Td
долларов, за счёт Венесуэлы?	Tu
его диагноз?	Tu
за Империю он или за Республику?	Td
закон против беззакония?	Tu
зачем КС?	Tu
зачем были потрачены деньги налогоплательщиков?	Tu
зачем мне орден?	Td
здесь бросить?	Tu
здесь кровь покупаете?	Tu
и Кремль нас уверяет, что в стране кризис?	Tu
и люди не улыбаются?	Tu
или салют, скажем?	Tu
интересная, любимая или ответственная?	Tu
история с продолжением?	Tu
к какому органу, к сердцу ли, к мозгу ли подаётся больше всего крови?	Td
к труду готовить хорошо, а зачем к обороне-то?	Tu
к чему все эти эксперименты?	Tu
как быть с памятью остальных жертв?	Td
как встретят?	Tu
как думаете, коллеги?	Tu
как так, почему бюджет у нас дефицитный?	Td
как это что, отец Павел?	Td
какие профессии востребованы?	Td
какие технологии, как рыбу кормить, как зимой ухаживать?	Tu
какова будет очерёдность, какой размер отчисления?	Tu
каковы результаты?	Td
когда ещё дадут-то?	Td
когда же почувствуем?	Td
когда начнём лепить скульптуры?	Tu
кому во вред, кому во благо?	Tu
кому лучше, губернатору или гражданам?	Tu
кому они нужны, если пешком ходить гораздо дешевле?	Td
красок, линий или в скульптуре?	Tu
крах или возрождение?	Td
кто же против того, чтобы прижучить мошенников?	Tu
кто за девушку платит, тот её и танцует?	Tu
кто нас финансирует?	Td
кто прав неправ?	Tu
куда девать подопечных?	Td
куда уж строже-то?	Td
ладно, пусть будет давление, но какую тогда цель оно преследует?	Td
логика отсутствует?	Tu
массовая депрессия, массовый невроз, а может, массовая шизофрения?	Tu
метеорит или чиновник?	Td
миссия сумасшедшего?	Tu
миф или реальность?	Tu
может ли её муж, военный пенсионер, получить ещё и гражданскую пенсию?	Tu
может, лучше двойка?	Tu
может, нас и за границу из-за наших долгов незаконно не пускают, вразрез с Конституцией?	Tu
может, не будем давать полный концерт, может, ей тяжело?	Tu
может, теперь резня закончится?	Tu
мол, а мы тут при чем?	Td
на экране их нужно разделить на группы, где углы прямые, а где нет?	Tu
надо ли делать ребёнку массаж, если он здоров?	Tu
например, куда лучше машину припарковать?	Td
началу века, середине или концу?	Td
наш Петя?	Tu
не в курсе что там и есть кладбище?	Tu
не передумали?	Tu
не так ли, Сергей Александрович?	Tu
необходимость или предрассудок?	Td
ну и на фига купила, класть уже некуда?	Tu
ну отчего же, Док?	Tu
ну что тёлка?	Td
ну что, всё в сборе?	Tu
нужно ли это нам, зрителям?	Td
она маленькая?	Tu
они преувеличены?	Tu
опять вылез из тумана?	Td
откуда взялась смерть?	Td
откуда подрядчики берут щебень?	Td
откуда такие тарифы, кто их устанавливает?	Td
откуда ценообразование?	Tu
очередное очковтирательство?	Tu
папа с мамой или дедушки-бабушки?	Tu
персонал её ведь выдвинул?	Tu
печатать ли статью?	Td
по незнанию?	Tu
показать высокий результат или, прежде всего, хорошую игру?	Td
почему борода синяя?	Td
почему втроём?	Tu
почему грязью засыпали?	Td
почему у Ирландии нет своих святых мучеников?	Td
почему у одних получилось, а у других нет?	Tu
при чем тут Донбасс?	Td
реально что ли сайт знакомств?	Td
революций этих?	Td
референдум или выборы?	Tu
решить проблему нелегко?	Tu
руб, уже отчитались перед своими коллегами?	Tu
с чего вы взяли, что я от них в восторге?	Td
с чем поздравляем?	Tu
сам понимаешь, кого возить во вторник?	Td
связано ли повышение цен, пусть и небольшое, с инфляцией?	Tu
скажите, как он выглядит?	Tu
сколько в Туве животных, хотя бы по группам?	Tu
служить по призыву, по контракту, выбрать альтернативную службу или вообще не служить?	Td
случай, когда лучше быть бедным?	Td
стоит в очередях?	Tu
счастливыми собственниками или потерпевшими?	Td
так ли уж вреден сахар?	Td
так пиши, а так нельзя?	Tu
тебя как звать-то?	Tu
тепло ли ему, сыт ли он, здоров ли он?	Td
тогда где справедливость?	Td
тон картофеля, который мы производим?	Tu
туризм или терроризм?	Tu
ты будешь чемпионом, а он вдруг не станет?	Tu
узнаем ли когда-нибудь?	Tu
успеют ли открыть школу к сроку?	Td
хотели литр бензина по 50 центов?	Tu
хочешь жить?	Tu
человек, чего добились?	Tu
чем мусульманский халат хуже костюма тройки?	Td
чему радуемся?	Tu
что в неё включать?	Td
что же этим хочет сказать Геннадий Викторович?	Tu
что за механизмы, что они исполняют?	Tu
что их объединяет?	Tu
что не так, в чём беда, где просчёт, упущение из внимания?	Tu
что раньше курица или яйцо?	Td
что сделали, покажите?	Tu
что, вот так обыденно?	Tu
что, всех будем переводить?	Tu
что, если их писал такой же научный негр, как я?	Tu
что, мол, машину не купишь, неужели не в состоянии?	Tu
