А без картошки?	Tu
А была ли революция?	Tu
А в общем, как дела?	Tu
А вдруг диабет?	Td
А вдруг у него, у этого торговца, не дай бог, туберкулёз?	Td
А впрочем, для чего тут кавычки?	Tu
А вы задумайтесь, чего вы так боитесь?	Tu
А вы чьих будете?	Td
А где же Исаак?	Tu
А где же старший, кандидат и доктор наук?	Td
А где музыканты?	Tu
А где ум у этих людей?	Tu
А действительно, от какого?	Tu
А еда?	Tu
А если и выйдет, то с какими потерями?	Td
А если с ней что-нибудь случилось?	Td
А живые?	Tu
А зачем оправдываться?	Td
А здесь что увидят?	Tu
А как быть региональным?	Tu
А как же авантюра?	Tu
А как же кристаллизованный интеллект, мудрость?	Tu
А как же с образованием, институтами?	Tu
А как обстоит в Мичуринске?	Td
А какой же он кормилец?	Td
А конкретнее?	Tu
А кто мешал, то?	Td
А куда мне это положить?	Td
А мальчик перед смертью боялся?	Tu
А может, все же исламисты?	Tu
А может, пусть и строят?	Tu
А может, это и к лучшему?	Tu
А не получится как с газом, электроэнергией, когда напрямую и нет альтернативы, кроме дров?	Tu
А неформально?	Tu
А о чём общались?	Tu
А пенсии и дороги, в конце концов?	Tu
А потом куда, в Мексику?	Td
А почему на июль, а не на февраль, к примеру?	Td
А прадедушка?	Tu
А рок-музыка для нас, тогдашних пацанов, чем была?	Tu
А с ребёнком?	Tu
А слабо рассмеяться?	Tu
А те, в машине что остались?	Tu
А теперь что?	Tu
А ты можешь обойтись без этого учебника?	Td
А ты?	Tu
А у вас у самой, милочка, есть хоть какое-нибудь жилье?	Tu
А чего от меня ожидается?	Td
А чем ваши же голоса, но купленные не у вас, хуже?	Td
А что в меню?	Tu
А что делает Брюссель?	Td
А что же будет, когда эти цены, возможно, снизятся?	Td
А что значит, один потерял шапку?	Tu
А что с безопасностью?	Tu
А что уж говорить о женщинах?	Td
А что, он должен гулять по улице?	Tu
А школы, детсады предусмотрены?	Tu
А эти разговоры бабушек, слегка посвящённых в проблему?	Tu
Автор чего добивается?	Td
Амиго, а фамилия у Вас, случаем, не на Л?	Tu
Аркадий, где деньги?	Tu
Батенька, Вы опять ходили в лес за грибами?	Tu
Без вины виноватый?	Tu
Безвизовый режим для китайцев?	Tu
Бессмысленная надежда?	Tu
Болельщица Индустрии?	Tu
Борьба с серыми зарплатами?	Tu
Будем возмущаться?	Tu
Будет учебник один, будет другой, да какая разница?	Td
Будете чай?	Td
Будут ли собаки убраны с территории?	Td
Бухгалтерские отчёты, например?	Td
Был ли какой-то негатив в происходящем?	Tu
Быть может, напрасно?	Tu
В Киеве, где остались те же депутаты и чиновничий аппарат, и где олигарх был выбран президентом?	Tu
В России инфляция больше, чем ожидалось?	Tu
В дождь, снег и мороз?	Tu
В каких классах пройдёт эксперимент?	Td
В каком году?	Tu
В корове?	Tu
В котором часу открывается бар гостиницы?	Td
В металле?	Tu
В общем, если здоровья не будет, то зачем Вам богатство?	Tu
В поисках инвестиций?	Tu
В смысле в ведущую организацию?	Tu
В таком случае, может быть, есть смысл хотя бы взглянуть на жизнь наших нынешних пенсионеров?	Tu
В цену номера включён завтрак?	Tu
В чем здесь логика, господа чиновники?	Tu
В чем суть нововведений?	Td
В чём ваш адреналин?	Td
В чём же всё-таки истинный смысл?	Td
В чём она была одета?	Tu
В чём смысл нововведения?	Tu
В этом случае ничего не может быть хуже, чем судья-лжец, согласны?	Tu
Вам ещё налить?	Tu
Вам не мешает, если я закурю?	Tu
Вам так захотелось?	Tu
Вас избрал коллектив?	Tu
Василий, а Вы, позвольте поинтересоваться, какие течения оппозиции представляете?	Tu
Ваши приедут?	Tu
Ведь если знают, что не осуществляется, то зачем спрашивают?	Tu
Ведь так хочется заглянуть, что там внутри?	Tu
Ведь, кажется, в деле с семьёй Русских Гудков помощь оказывал?	Tu
Вершки или корешки?	Td
Видели, как он переживал?	Tu
Видите, что творят?	Tu
Владыка, что в ваших планах как епископа?	Td
Во сколько мы приземлимся?	Tu
Во сколько ты встаёшь?	Td
Во сколько это обошлось?	Td
Вода уже кипит?	Tu
Вокзал для двоих, или Что делать, если украли документы?	Tu
Вопрос риторический?	Tu
Вот только хватит ли их, этих баллов, для общей победы?	Tu
Впечатляет, не правда ли?	Tu
Время без принципов, говорите?	Tu
Все ошибаются, но так?	Tu
Всех расстрелять?	Tu
Всё в порядке?	Tu
Входит ли это в медицинское страхование?	Tu
Вы будете платить отдельно, или вам общий счёт?	Td
Вы в этом уверены?	Tu
Вы видели хотя бы одно ведомство, которое не хотело бы расширить свои полномочия, финансирование, сферы влияния?	Tu
Вы думаете, она русских ненавидит?	Tu
Вы ей говорили, что тяжёлый график, и надо бы поберечь себя?	Tu
Вы же уже сами всё поняли, да?	Tu
Вы здесь впервые?	Tu
Вы знаете английский?	Td
Вы знаете человека по фамилии Муратидис?	Tu
Вы издалека?	Tu
Вы как, дойти сможете?	Tu
Вы меня ждёте?	Tu
Вы меня понимаете?	Td
Вы мне можете помочь отодвинуть машину в сторону?	Td
Вы могли бы что-то для меня сделать?	Td
Вы можете мне показать дорогу?	Td
Вы можете мне это более подробно объяснить?	Td
Вы можете мне это объяснить?	Td
Вы можете оказать мне услугу?	Td
Вы можете связаться с посольством Чехии и сообщить, что случилось?	Td
Вы нас уже покидаете?	Tu
Вы не могли бы мне принести одеяло?	Td
Вы не могли бы проверить чек?	Tu
Вы носите очки?	Td
Вы подвезёте меня в город?	Td
Вы предлагаете, чтобы я в футбол начал играть?	Td
Вы принесёте нам чистые полотенца?	Td
Вы продаёте носители данных?	Td
Вы родственники?	Tu
Вы сердитесь на меня?	Tu
Вы случайно не господин?	Tu
Вы спрашиваете, как мы выдерживали?	Tu
Вы спросите, при чем тут медицина?	Tu
Вы тут все тульские?	Td
Вы умеете включить автоматический выключатель?	Td
Вы хорошо знаете Прагу?	Td
Вы хотите пить или есть?	Td
Вы хотите, чтобы я это сделал?	Tu
Вы это не читали?	Tu
Выходит, ключ к стройной фигуре лежит в нашей психике?	Tu
Вячеслав, а кто нас победит?	Tu
Вячеслав, опять развели помойку для своих?	Tu
Где ближайший банкомат?	Td
Где вагоны переговорщиков?	Td
Где видит себя Вика в будущем?	Td
Где вы работаете?	Tu
Где выключатель?	Tu
Где деньги, арендатор?	Tu
Где же инстинкт самосохранения?	Td
Где здесь душевая?	Td
Где здесь можно заняться рыбалкой?	Td
Где здесь поблизости можно переночевать?	Td
Где криминал?	Td
Где логика?	Td
Где мне надо выйти?	Td
Где можно ловить рыбу?	Td
Где можно проконсультироваться?	Tu
Где мы сидим?	Tu
Где найти информацию о городе?	Td
Где находится наш номер?	Td
Где наши места?	Tu
Где он, тот коммунизм?	Td
Где оценка ввода войск, где перспективы эскалации?	Tu
Где предел, где порог?	Td
Где продаются билеты?	Td
Где справедливость?	Tu
Где теперь феодализм?	Tu
Где ты был в прошлый раз?	Td
Где у вас болит?	Td
Где черта?	Td
Где это можно достать?	Tu
Где я могу купить билеты?	Td
Где, если не здесь?	Td
Герои или бандиты?	Td
Говорите, дорога планируется?	Tu
Год пишешь роман и целый год не пишешь стихи?	Tu
Горжусь им, как иначе?	Tu
Господи, почему ты что-нибудь не возьмёшь?	Td
Гребни или лунки?	Td
Громче ли она, чем сам киносеанс?	Tu
Да земляков ли?	Td
Да и старшие?	Tu
Да ты что, с ума сошёл?	Td
Дадут ли маме сертификат, если в семье появится ещё один ребёнок?	Td
Далеко ли уезжают?	Tu
Две штуки?	Tu
Действительно, кто ж не в курсе?	Td
День России праздник или трагедия?	Tu
Детей из школ забрали?	Tu
Для высших управленческих структур, для класса госслужащих вообще?	Tu
Для чего нужен мальчишник?	Tu
Для червей в земле?	Tu
До какой даты можно аннулировать заказ без штрафа?	Td
Доколе он терпит, не верит и пьёт?	Tu
Дома безопасно?	Tu
Другие, спустя время, удивляются, откуда у них взялась онкология?	Tu
Думаете, герой не может быть смешным?	Tu
Думаю, неужели не смогу?	Td
Его какая муха укусила?	Td
Если ничего, кроме таких вещей, народу предложить нельзя, то какой выход?	Td
Есть в близи какой-нибудь парк?	Td
Есть здесь бассейн с противотоком?	Td
Есть здесь отделение для некурящих?	Td
Есть здесь поблизости спортивная площадка?	Td
Есть ли в России бюджетники?	Td
Есть ли номер подешевле?	Td
Есть ли у павильона адрес?	Td
Есть у вас ещё другой электронный адрес?	Td
Есть удачные фотографии?	Td
Ещё что-нибудь?	Tu
Женя, а это что, обязательные издержки, а не обесценивание?	Tu
Жильцы в ответе?	Tu
За какую команду он играет?	Td
За сколько времени до вылета нужно прибыть в аэропорт?	Td
За чей счёт банкет?	Tu
За чьё светлое будущее?	Td
Завтра у вас есть свободное время в три часа дня?	Td
Закон о кооперации?	Tu
Затопить камин?	Td
Зачем вообще о них сообщают во всеуслышание?	Tu
Зачем едем?	Td
Зачем злиться, сравнивая их с зарплатой медсестры 12 тысяч в месяц?	Td
Зачем обижать женщин?	Td
Зачем пишу?	Tu
Зачем сиськи, когда есть свои?	Tu
Зачем трудилась?	Tu
Зачем это?	Td
Зверь или человек?	Td
Здесь есть школа подводного плавания?	Tu
Здесь можно взять напрокат лодку?	Tu
Здесь можно прыгать в воду?	Tu
Здесь рецепт платный?	Tu
Знаете, о чём сейчас подумал?	Td
Знаешь, как я устал?	Td
Значит, да?	Tu
Значит, стреляли в воздух?	Tu
И будет ли оно счастливым, это вселение, это новоселье?	Tu
И вообще откуда дровишки?	Td
И все-таки, к чему готовиться простым людям, как на их жизни отразится кризис?	Td
И где здесь справедливость?	Tu
И есть в нашей комнате душ?	Tu
И знаешь, что обнаружили?	Tu
И как так можно над людьми издеваться, в толк не возьму?	Td
И какое это чувство?	Td
И на том же языке, на тех же языках?	Tu
И последнее а, собственно, что мы будем реконструировать?	Td
И почему тебя ненавидят, бомба?	Td
И про лён не понял, а вообще он зачем?	Td
И с чем останемся?	Tu
И туалетной бумаги?	Tu
И что будет с нашей деревней, людьми?	Tu
И что он лично, по обращениям граждан, сделал?	Td
И что сделала прокуратура, чтобы защитить права граждан, а жуликов привлечь к ответственности?	Td
И что, на Украине что изменилось?	Tu
И чтобы не фикция, а реальная юрисдикция?	Tu
И, по вашим ощущениям, они будут продолжать выходить?	Tu
Из Северной в Южную?	Tu
Извините?	Tu
Или беспомощность перед нарушителями?	Tu
Или гастарбайтеры?	Tu
Или их были не миллионы, а единицы?	Tu
Или обувь вам ремонтировать?	Tu
Или родственники, соседи её обижают?	Td
Или у неё большой стаж работы в хирургии?	Tu
Или что-то объединяет, но не патриотизм, а что тогда?	Td
Имеется ли здесь поблизости больница?	Tu
Иностранный язык учил, музыкой занимался, спортивную секцию посещал и вдруг убежал?	Tu
Интересно, как же у Грузии получилось победить свою коррупцию?	Tu
Интересно, отдают ли они себе отчёт в том, кем их готовят и для чего?	Tu
Исторический прилив закончился, и начался отлив?	Tu
Итак, каков эффект наших публикаций?	Tu
Итог десятилетия?	Tu
Июнь в разгаре, а сколько пляжей открыто в Волгограде?	Tu
К кому мне обратиться?	Tu
К чему адаптироваться?	Tu
К чему мы продвинулись?	Td
Кажется фантастикой?	Tu
Казалось бы, чего тут необычного?	Tu
Как будем мерить эффективность?	Td
Как быстро вы это можете отремонтировать?	Td
Как в целом идёт внедрение информационных технологий?	Td
Как ваша семья?	Tu
Как всё будет оформлено?	Td
Как вы думаете, почему?	Tu
Как вы считаете, почему?	Tu
Как выразить в рублях то, кто учит лучше, а кто хуже?	Tu
Как дела?	Tu
Как долго будет идти дождь?	Td
Как долго вы уже здесь ждёте?	Td
Как долго длится удовлетворение рекламации?	Td
Как долго мне принимать это лекарство?	Td
Как долго простоит эта погода?	Td
Как долго я должен остаться в больнице?	Td
Как её свести к минимуму?	Td
Как же он вновь умудрился попасть в Россию?	Td
Как же расценивать ту неискренность, которая, судя по всему, встречается в любых дружеских отношениях?	Tu
Как жителю Марий Эл объявить себя банкротом?	Td
Как избежать неудач при выращивании лагенарии?	Td
Как минимизировать ущерб?	Td
Как мне оформить свой гараж в собственность?	Td
Как мне это понять?	Td
Как называется столица Исландии?	Td
Как нам попасть в чешское посольство?	Td
Как насчёт того, чтобы позвонить ей?	Td
Как он переживает это?	Td
Как перестать себя мучить, бабушка?	Tu
Как поживаешь?	Tu
Как помочь нашим детям стать здоровыми, успешными и счастливыми?	Td
Как происходит процесс уничтожения?	Td
Как скоро мы доберёмся туда?	Td
Как твои родители?	Tu
Как ты думаешь, тебя заметят?	Tu
Как ты посмел сказать такое?	Td
Как у тебя получалось?	Tu
Как часто вы ездите за границу?	Td
Как это Гитлер возьмёт Москву?	Td
Как это делается?	Tu
Как это продолжается?	Td
Как я выгляжу?	Td
Как, на ваш взгляд, возможно ли их вообще победить?	Td
Какая загвоздка получается?	Td
Какая муха тебя укусила?	Td
Какая разница?	Td
Какая у вас теперь погода?	Td
Какие впечатления?	Tu
Какие мечты осуществили?	Td
Какие помехи для бизнесменов видят депутаты?	Td
Какие твои планы на будущее?	Td
Какие у вас хобби?	Tu
Какие чувства вы испытываете друг к другу?	Td
Каких таких перемен?	Td
Каков здесь вклад здравоохранения?	Tu
Каков срок эксплуатации счётчиков?	Td
Какова их схема?	Td
Какова тенденция?	Tu
Какого вы об этом мнения?	Tu
Какого ты роста?	Td
Какое здесь разрешение?	Td
Какое слово длиннее змея или червячок?	Td
Какой был период, можете уточнить?	Td
Какой ещё кворум?	Td
Какой начальный оклад могу ожидать?	Td
Какой парламентаризм?	Tu
Какой самый большой?	Td
Какой счёт?	Td
Какой у вас адрес электронной почты?	Td
Какой у них шанс найти его?	Td
Какой финальный счёт?	Td
Какой шампунь, гель, лак для этой благородной цели купить?	Tu
Какую форму это имело, прежде всего?	Td
Кем запланированы?	Td
Кем финансируется проект?	Tu
Клуб прогрессирует?	Tu
Когда будет моя очередь?	Td
Когда вам угодно?	Td
Когда вы меня выпишете?	Td
Когда вы родились?	Tu
Когда корт освободится?	Td
Когда мы встретимся?	Tu
Когда начнутся погружения на открытой воде?	Td
Когда она начнётся, сколько продлится?	Td
Когда отправляется следующий поезд в?	Tu
Когда ты его видел в последний раз?	Td
Когда ты приедешь?	Tu
Когда убирать картофель?	Td
Когда это случилось?	Td
Кого выберем?	Tu
Колонны каких болельщиков шли к стадиону?	Tu
Кому это интересно?	Tu
Концепция что ли изменилась?	Td
Который вы бы мне рекомендовали?	Td
Кошелёк или жизнь?	Tu
Кстати, а где идейный вдохновитель?	Tu
Кстати, как зовут вашу героиню?	Tu
Кто будет возить пассажиров в Новомосковске?	Td
Кто в зоопарке долгожитель?	Tu
Кто вам это сказал?	Tu
Кто выиграл?	Tu
Кто дежурит?	Td
Кто же преступник?	Td
Кто здесь ответственный?	Tu
Кто играет сегодня вечером?	Td
Кто имел преимущество в движении?	Tu
Кто мог предвидеть это?	Td
Кто они, герои истории?	Td
Кто отсутствует?	Tu
Кто пострадает от последствий глобального потепления?	Tu
Кто расписывается?	Tu
Кто следующий, господа?	Tu
Кто там фигурирует?	Td
Кто тебе это посоветовал?	Tu
Кто трогал мой компьютер?	Tu
Кто хозяин у бревна?	Td
Кто это был?	Td
Кто это?	Tu
Кто-нибудь поможет мне открыть счёт пользователя?	Td
Куда ведёт эта дорога?	Td
Куда делись молодые?	Td
Куда же этот мир катится?	Td
Куда мне это сложить?	Td
Куда обратиться, если мой багаж потерялся?	Td
Куда он это дел?	Td
Куда смотрит отдел полиции, занимающийся несовершеннолетними?	Td
Куда точно вы отбуксируете мою машину?	Td
Куда ты это спрятал?	Tu
Культовый режиссёр?	Tu
Лермонтова, Вам интересны?	Tu
Лицей для одарённых в физике и математике людей?	Tu
Лондон или Санкт-Петербург?	Tu
Любите ананасы?	Td
Магазин автозапчастей?	Tu
Марка какой стоимости мне нужна в?	Td
Между вами что-нибудь происходит?	Tu
Менять бампер из-за царапин?	Tu
Мне идёт?	Tu
Мне придётся заполнить таможенную декларацию?	Tu
Мне это открыть?	Tu
Мог бы быть снайпер?	Tu
Могу идти вперёд и ждать наверху?	Tu
Могу оставить свой велосипед в подвале?	Td
Могу получить что-то от боли?	Tu
Могу посмотреть это?	Td
Могу это принимать вместе с?	Td
Могу я обратиться к вам с просьбой?	Td
Могу я получить квитанцию?	Tu
Могу я это одолжить?	Td
Можем встретиться завтра в пять часов дня?	Td
Может быть, готовят там вкусно?	Td
Может быть, как путь к искусству?	Tu
Может быть, уступить, но тогда он сядет на шею?	Td
Может ещё под землю спрятаться?	Td
Может, Функционирует Центр?	Tu
Может, все дара речи лишились?	Tu
Может, детские капризы?	Tu
Может, кто подскажет?	Tu
Может, мы уже всё, что нужно, модернизировали?	Tu
Может, опасения беспочвенны?	Tu
Может, ошибка вышла?	Td
Может, пора опять вернуть эту практику?	Td
Может, свою счастливую судьбу?	Tu
Может, судачок?	Tu
Может, фильм не ко мне обращается?	Td
Можете говорить громко и отчётливо?	Td
Можете меня подвезти до ближайшей бензоколонки?	Td
Можете мне показать вашу плацкарту?	Td
Можешь говорить громче?	Tu
Можно вас на минуту?	Td
Можно взять ваш пояс?	Td
Можно включить телевизор?	Td
Можно ещё одну, пожалуйста?	Td
Можно здесь взять снегоход?	Td
Можно здесь переночевать?	Td
Можно к вам присоединиться?	Tu
Можно ли ему доверять?	Tu
Можно ли это сократить?	Td
Можно мне от вас позвонить?	Td
Можно мне уже уйти?	Td
Можно опять презентацию?	Td
Можно пить эту воду?	Td
Можно покататься и узнать, всё ли в порядке?	Tu
Можно попросить место у окна?	Td
Можно сидеть впереди?	Td
Можно, я напишу её через одну, после той, которую я пишу теперь?	Td
Мол, с чего вы взяли, что это деньги?	Tu
Мы в субботу не виделись?	Tu
Мы готовимся к войне, а не к кризису?	Tu
Мы знакомы?	Td
Мы можем осмотреть дом?	Td
Мы сходим куда-нибудь сегодня вечером?	Td
НКО не хотят публичности?	Tu
На каком автобусе туда доехать?	Td
На когда мы договоримся?	Tu
На себя взгляните, а?	Tu
На теплоходе есть буфет?	Tu
На что вы намекаете?	Tu
На чьей стороне ты?	Td
Наверное, архивы?	Tu
Наверняка не вслепую?	Tu
Надеюсь, процент явки Вам известен?	Tu
Например, платина или палладий?	Td
Наташа, что тут ещё добавить?	Td
Нашли, чем их заменить?	Tu
Не было ни денег, ни времени, ни желания?	Td
Не миф ли он, как созданный советский язык?	Td
Не могли бы мы встретиться?	Td
Не нужно, ты считаешь?	Td
Не подскажете, где мне выйти?	Td
Не правда ли, хлопотно?	Tu
Не соцреализм же у нас, в конце концов?	Td
Не тот ли Вы Новиков, что с Баррикад?	Td
Не хотели бы Вы?	Tu
Не хочешь сходить на хоккей?	Td
Нельзя ли потесниться?	Tu
Немцова по ошибке расстреляли?	Tu
Нет, много кричали?	Tu
Неужели те, кого он спас, его не найдут?	Td
Неурожай, например?	Tu
Ни в России, ни в Союзе Так не делали, скажи?	Tu
Но видел ли он что-нибудь?	Td
Но где она, эта рябина?	Tu
Но как бюджету обойтись без этих средств?	Td
Но какие же бешеные деньги нужны, чтоб вот так развернуться?	Td
Но почему люди убеждены, что зло непобедимо?	Tu
Но разве только люди могут чувствовать, сопереживать?	Td
Но что мы всё о деньгах?	Td
Но, с другой-то стороны, какие у Лукашенко риски?	Tu
Ну а теперь, по окончании выборов, чего ждать?	Tu
Ну и как урегулировать?	Tu
Ну и что тут такого?	Td
Ну какие же мы борцы за коммунизм, если знаний не хватает?	Td
Ну уж, знаешь ли?	Td
Ну что, будем прощаться, или ещё у нас есть разговор?	Tu
Ну, есть у людей совесть?	Td
Ну, какой смысл размещать в газете рекламу?	Tu
Ну, чего стоишь?	Td
Ну, что я тебе говорил?	Tu
Нужен ли русскому языку сити-менеджер?	Tu
Нужно ли разрешение на рыбалку?	Td
О ком ты говоришь?	Td
О чем жалею?	Tu
О чём мечтают?	Td
О школьной, например?	Tu
Обсуждают, где душа?	Tu
Оказал ли помощь владелец собаки?	Td
Он где-нибудь здесь?	Tu
Он же брал?	Tu
Он курирует Чемпионат?	Tu
Он там?	Tu
Он что особенный?	Tu
Она красивая?	Tu
Она что, виновата, что она из хорошей семьи, ещё советской?	Tu
Они живут за счёт ипотеки, почему будут отказывать?	Td
Они сдают комнаты?	Td
Оплачиваете дорожные чеки?	Td
Опять к зиме не готовы?	Td
Особенно на жителях?	Tu
От глупости, наконец?	Tu
От кого ты это получил?	Tu
Ответ очевиден, нет?	Tu
Откуда взялась, почему учит наших детей?	Tu
Откуда же они возьмутся, эти идеи?	Tu
Откуда отправляются прогулочные теплоходы?	Td
Откуда ты это взял?	Td
Отстали от честных предпринимателей?	Td
Отчего же?	Td
Ошибочка, говорите?	Tu
Паспорт или досье?	Td
Пенсия подросла, а вы и не заметили?	Tu
Петрович то тут причём?	Td
Пишите под копирку?	Tu
По дороге есть крутые подъёмы?	Td
По какому праву?	Tu
Подайте мне, пожалуйста?	Tu
Подскажите пожалуйста, на какой поезд пересесть в?	Tu
Подскажите, пожалуйста, есть ли военная кафедра на факультете?	Td
Позвонишь мне когда-нибудь?	Td
Пойдём по рюмке выпьем?	Tu
Получается, что меня и моих соседей вводят в заблуждение?	Tu
Помните маму Дяди Фёдора?	Td
Помните, как жарко было в августе?	Td
Понимаешь, в чём специфика СМИ украинских?	Tu
Понятно, что связано с выборами, но какова цель?	Td
Посидим у стойки бара?	Tu
Потанцуем?	Tu
Почему Гамлет бездействует?	Td
Почему Стрелков?	Tu
Почему бы им, действительно, научный коммунизм не преподавать?	Tu
Почему в сентябре пришли две квитанции?	Td
Почему вообще ушло, а куда, к кому и в каком виде пришло?	Tu
Почему же его здесь нет?	Td
Почему именно российскими?	Tu
Почему люди стремятся сюда, живя за тридевять земель, где уровень и жизни, и медицины выше российского?	Td
Почему не едете на метро?	Td
Почему несуразица?	Tu
Почему он собственно звонил?	Td
Почему они взлетели?	Td
Почему отложили?	Tu
Почему с подвигом?	Td
Почему ты меня перебиваешь?	Tu
Почему ты это сделал?	Td
Почему читаю, а не смотрю?	Tu
Почему я упомянул Францию?	Tu
Почему?	Tu
Пошли, что ли?	Td
Правда же, сразу видна разница?	Td
Представляете, да?	Tu
Предъявлять ли паспорт полицейскому?	Td
Привет. Можно присесть?	Td
Призрак оперы?	Tu
Прогулка отменяется?	Tu
Простите, как вас зовут?	Td
Процесс запущен, а результата нет?	Tu
Пугают девальвацией?	Tu
Пушкин будет?	Tu
Работали в архивах, изучали документы?	Td
Ради чего?	Tu
Разве коммунизм плохая цель?	Tu
Разве тут до больничного?	Tu
Разве это не доказывает, что он сумасшедший?	Tu
Разница очевидна, нет?	Tu
Разрешите?	Tu
Расскажите, кому она положена?	Td
Ребята, вы считать умеете?	Tu
Региональные университеты?	Tu
Речь идёт о тех, кто работает без оформления, нелегально?	Tu
Роман Гребенников сжигает мосты?	Tu
Русская зима станет настоящей?	Tu
Ручка или компьютер?	Tu
С каждым годом легче или наоборот, бюджет меньше, а ответственность больше?	Td
С какой платформы отходит поезд в?	Tu
С кем имею честь?	Tu
С кого, по-твоему, начался русский рэп в России?	Tu
С такими темпами, пожалуй, и эпидемия в республику придёт раньше?	Td
С чем и с кем останемся?	Td
С чем ты к нам пришёл?	Tu
Сами пишите?	Tu
Свет отключат?	Tu
Связь поддерживаете?	Tu
Сегодня войти в бизнес легче, чем тогда, когда вы начинали?	Td
Семью кормить?	Tu
Сечёшь?	Tu
Скажете, бред?	Tu
Скажете, фантастика?	Tu
Скажите, Александр Владимирович, так можно купаться в Волге или нет?	Tu
Скажите, какова судьба русской версии книги?	Tu
Ски-пасс действителен на всех подьёмниках?	Td
Сколько весит эта гантель?	Td
Сколько времени займёт осмотр?	Td
Сколько времени это займёт?	Tu
Сколько денег мне надо обменять?	Td
Сколько же можно жаловаться?	Td
Сколько литров топлива поместится в баке?	Td
Сколько нужно бюджетных средств, чтобы привлечь профессионалов?	Tu
Сколько примерно это будет стоить?	Td
Сколько раз мне это повторять?	Td
Сколько стоит билет со скидкой в 50%?	Td
Сколько стоит минута ожидания?	Td
Сколько стоит паром для машины и двух человек?	Td
Сколько стоит такси в аэропорт?	Tu
Сколько там будет людей?	Tu
Сколько ты зарабатываешь в месяц?	Tu
Сколько у тебя денег?	Tu
Сколько это километров?	Tu
Сколько это стоит на час?	Td
Слезть с иглы?	Tu
Служба в Межевой канцелярии?	Tu
Слышали, что обвинитель говорил?	Td
Смогут ли врачи помочь всем нуждающимся?	Td
Со скольких лет?	Tu
Согласитесь, интересный факт?	Tu
Сотки, чьи вы будете?	Td
Спрашивается, кому мешал наш ларёк?	Tu
Спросите, чем привлечь?	Tu
Стакан водки выпьем?	Tu
Стоит ли беспокоиться?	Td
Строителя коммунизма?	Tu
Супермаркеты пешей доступности?	Tu
Сынок, как экзамены?	Tu
Так выгоднее?	Tu
Так зачем дважды тратиться и тем, и другим?	Td
Так кто же маньяк?	Tu
Так что же предпринимать, чтобы уменьшить дискомфорт?	Tu
Так что, у США всё будет замечательно?	Tu
Такое впечатление, что не договорились?	Tu
Там есть где-нибудь туалет?	Td
Твоё предложение ещё в силе?	Tu
Тебе не холодно?	Tu
Тебе понравился этот фильм?	Td
Тебя подвезти куда-нибудь?	Td
Теоретик, да?	Tu
Теперь этот турнир для вас особенный?	Tu
То есть за счёт импорта?	Tu
То, что уже существует в научном сообществе, это уже терминология?	Tu
Только Германия?	Tu
Топтать чужие могилы?	Tu
Три белых, две чёрных?	Tu
Ты будешь на Рождество дома?	Td
Ты в своём уме?	Td
Ты видел этих девушек?	Td
Ты всё ещё ищешь работу?	Tu
Ты где проявляешь плёнки?	Td
Ты донесёшь?	Tu
Ты ему это продал, так?	Td
Ты женишься на мне?	Td
Ты заправил кровать?	Td
Ты играешь на гитаре?	Tu
Ты любишь классическую музыку?	Td
Ты меня слышишь?	Tu
Ты можешь её поменять?	Td
Ты можешь простить меня?	Td
Ты намазался солнцезащитным кремом?	Td
Ты не умеешь говорить?	Tu
Ты не хочешь прийти?	Td
Ты одолжишь мне денег?	Td
Ты переживал, что ты не там, не на площади?	Tu
Ты поможешь мне с этим?	Td
Ты посмотрел эту статью?	Td
Ты примерял этот свитер?	Td
Ты работаешь на него, не правда ли?	Td
Ты с кем-нибудь встречаешься?	Tu
Ты сдал экзамены?	Td
Ты слушаешь меня?	Td
Ты справишься с этим?	Td
Ты там вообще был когда-нибудь?	Td
Ты уж прости меня, ладно?	Tu
Ты уже когда-нибудь был в театре?	Td
Ты уже окончил учёбу?	Td
Ты уже смотрел этот фильм?	Td
Ты умеешь играть на рояле?	Tu
Ты умеешь читать карту?	Td
Ты хорошо провёл время на вечеринке?	Td
Ты чего, с луны свалился?	Td
Ты что, дошёл сюда пешком?	Tu
Ты что, язык проглотил?	Td
Ты это всерьёз?	Tu
Ты это сделал?	Tu
Ты это уже понял?	Tu
У Вас аллергии?	Tu
У вас есть дети, внуки, любимый муж, зачем вам всё это надо?	Td
У вас есть какие-нибудь предложения?	Td
У вас есть проблемы с футбольными хулиганами?	Td
У вас есть свободные места на период?	Td
У вас есть собственный гараж?	Td
У вас можно найти свободное место?	Td
У вас слепой парикмахер?	Tu
У нас есть возможность выбора?	Td
У тебя есть девушка?	Td
У тебя есть подружка?	Td
У тебя спички есть?	Tu
Угадайте, почему?	Tu
Уже два месяца, как субсидии есть, а что сделано?	Tu
Уличная безопасность?	Tu
Упадёт, кто будет отвечать?	Tu
Утопия, скажете?	Tu
ФИО и адрес?	Tu
Фольклор, говорите?	Tu
Хватит этого?	Td
Хорошо ещё фура оказалась, а если легковушка?	Tu
Хотите знать, о чём думают сегодняшние школьники?	Td
Хотите удивляться, удивляться и удивляться?	Tu
Хотите, я вам её покажу?	Tu
Хотя нет, пообещать смогут многие, но вот кто сможет гарантировать?	Tu
Хочешь быть публичной фигурой, политиком?	Tu
Хочешь ноутбук?	Tu
Хочешь, дорогой?	Tu
Ценим ли мы мир в Европе?	Tu
Чего бояться, если это неизбежно?	Tu
Чего испугались?	Tu
Чего сидим?	Tu
Чего ты ещё хочешь?	Td
Чего этим хочешь добиться?	Td
Чем бы Вы занялись?	Tu
Чем год прирос?	Td
Чем же она объясняется?	Tu
Чем закончилось разбирательство?	Td
Чем колледж отличается от техникума?	Tu
Чем обосновать, провести оплату?	Td
Чем опасны комментарии?	Tu
Чем топить?	Td
Чем чёрт не шутит, когда разум спит?	Td
Чему они учат?	Td
Чему учит ваш спектакль?	Td
Чему это поможет?	Tu
Читает, говорите?	Td
Что бы в газете хотелось увидеть ещё?	Td
Что в активе?	Tu
Что вам кекс ясно?	Td
Что вас интересует?	Td
Что входит в цену?	Td
Что вы ищете?	Tu
Что вы сказали?	Tu
Что выгоднее?	Td
Что делать, если вещи пропали из ячейки?	Td
Что есть у коммунистов?	Td
Что ещё?	Tu
Что же в Арктике миф, а что реальность?	Td
Что же такого, в конце концов, обсудят в ПАСЕ 2 октября?	Tu
Что же физическое?	Tu
Что за профессии выберут?	Tu
Что здесь обсуждается?	Tu
Что значит это слово?	Td
Что изменилось в связи с этим в жизни судовладельцев?	Tu
Что мне делать?	Td
Что мне сказать?	Td
Что на тебя напало?	Tu
Что он говорил?	Tu
Что она может, кроме борща?	Td
Что от тебя хочет?	Tu
Что планируете поменять, добавить, убрать?	Td
Что последует далее?	Tu
Что предстоит ей в жизни, будет ли она счастливой?	Td
Что решил УЕФА?	Td
Что с тобой?	Td
Что скажут люди?	Td
Что такое лидер Англии, лидер Голландии?	Tu
Что там, за границей, ещё хуже, чем у нас?	Tu
Что тебе угодно?	Td
Что тебя мучит?	Td
Что тут у вас происходит, товарищ Медведев?	Tu
Что ты делаешь с этим?	Td
Что ты запланировал на сегодняшний вечер?	Td
Что ты любишь делать больше всего?	Td
Что ты нам принёс?	Tu
Что ты пишешь?	Tu
Что ты разыгрываешь?	Tu
Что ты читаешь?	Td
Что уж говорить о пожилых, пенсионерах?	Td
Что эта работа собой представляет?	Td
Что это за фигня?	Td
Что я могу для вас сделать?	Tu
Что я тебе, философ?	Tu
Что, дружба пошла не в пользу?	Tu
Что, не знаете сценарий?	Tu
Что, согласно инструкции, обязаны сделать в этом случае продавцы и охранники?	Td
Что-нибудь не в порядке?	Tu
Чтоб указывать, кому и чего делать?	Tu
Чья здесь вина?	Td
Чья это ошибка?	Td
Чёрт, вот как можно так снять фильм о любви?	Td
Эй, ты чего там заглохла?	Td
Эта сумма возвращается?	Tu
Это билет с правом пересадки?	Tu
Это был не он, правда?	Tu
Это возможно?	Tu
Это данные, полученные наблюдателями?	Tu
Это достигло своей цели?	Td
Это интеллигенция, а народ?	Tu
Это мне?	Tu
Это обследование для меня необходимо?	Tu
Это платная парковка?	Tu
Это разные города, опять же по ощущениям?	Td
Это стоит того?	Td
Это уже отремонтировано?	Tu
Это, что, профессия, когда город на глазах разваливается?	Td
Этот стол свободный?	Tu
Я говорю, что не знаю, как быть, чем там лечить будут?	Tu
Я ей квартиру купил, представляешь себе?	Td
Я могу позволить собаке бегать без поводка?	Td
Я опоздал?	Tu
Я собираюсь на футбол. Ты пойдёшь со мной?	Tu
Я тут при чём?	Td
а вдруг не отдадут хозяину?	Tu
а где он будет избираться?	Tu
а нужно ли было тогда, в 2011-м, так рубить сплеча?	Td
а терроризм это плохо или хорошо?	Td
атеизм как авторитаризм?	Tu
в чём выгода России от достигнутых договорённостей?	Td
вдруг трезвый?	Tu
во всём мире ситуация ухудшается, чем мы лучше?	Tu
вся Турция в теплицах, а нам что мешает?	Td
выделялись ли данные участки, кем выделялись?	Td
где лучше возят?	Td
господи, где были мои глаза?	Tu
дзюдо не нравится?	Tu
жив ли, способен ли продолжить бой?	Td
зачем зря обижать человека?	Td
и бюджет пополнять, и народ не обижать?	Tu
йога и бизнес?	Tu
как всегда, неожиданность?	Tu
как, на Ваш взгляд, возможен ли в России когда-либо переход к парламентской республике?	Tu
квартира, деньги?	Tu
кому и чем нравится пляж?	Td
кто в доме хозяин?	Tu
кубометров, поступающих из России?	Tu
лучше свобода, чем несвобода?	Tu
много Вы создали Советов домов, Общественники?	Td
может, она идёт от нашей биографии?	Tu
налог отменяется, если срок добавляется?	Tu
не исчезнут ли их книги вообще из школы?	Td
ну как там, в Париже?	Td
обман или конкуренция?	Tu
откуда же в этой связи взялась Украина?	Tu
ошибка пилотов или неисправность?	Td
по типу Ижевска?	Tu
почему мы не Сингапур?	Tu
ребята, вы что, считаете, что Крым ваш?	Tu
с двигателями?	Tu
сетях уже будут заранее?	Tu
специальные парашюты?	Tu
те, кто там прописан?	Tu
ту же гречку, ту же картошку у нас что, своей картошки нет?	Td
химии наверняка много?	Tu
чем, как вы говорите, петля вам не угодила?	Tu
что им выгоднее?	Td
что тянет мужчину к женщине?	Td
я лично по профессии инженер, а кто Вы по профессии?	Tu
